Player,Position,League,Age,90s,Players_tackled,Tackles_won,Tackles_def3rd,Tackles_mid3rd,Tackles_att3rd,Dribblers_tackled,Dribblers_challenged,Dribbers_tackled%,Challenges_lost,Number_of_blocks,Shots_blocked,Passes_blocked,Interceptions,Number_of_Players_tackles_and_Int,Clearances,Errors_leading_to_shot,Minutes
Montassar Talbi,0,3,24,38.0,53,25,40,13,0,22,35,62.9,13,55,34,21,40,93,190,3,3420.0
James Tarkowski,0,1,29,38.0,51,26,36,13,2,20,38,52.6,18,99,78,21,51,102,201,3,3420.0
Gabriel Dos Santos,0,1,24,37.9,48,30,29,15,4,18,27,66.7,9,49,26,23,32,80,125,2,3411.0
Fran Garcia,0,2,22,37.9,84,54,53,23,8,55,96,57.3,41,49,8,41,44,128,66,0,3411.0
Birama Touré,6,3,30,37.8,80,47,35,35,10,34,93,36.6,59,54,9,45,67,147,49,0,3401.9999999999995
Harry Kane,3,1,29,37.8,15,12,1,6,8,7,21,33.3,14,27,7,20,2,17,18,0,3401.9999999999995
Alex Iwobi,8,1,26,37.5,69,37,37,28,4,33,65,50.8,32,41,2,39,25,94,29,0,3375.0
James Ward-Prowse,6,1,27,37.5,65,37,31,27,7,21,61,34.4,40,30,10,20,55,120,48,0,3375.0
Kieran Trippier,0,1,31,37.1,71,49,36,27,8,46,90,51.1,44,45,15,30,43,114,84,2,3339.0
Yunis Abdelhamid,0,3,34,37.0,82,50,47,33,2,39,52,75.0,13,65,27,38,64,146,116,1,3330.0
Axel Disasi,0,3,24,37.0,30,20,13,13,4,13,27,48.1,14,51,31,20,56,86,112,2,3330.0
Federico Baschirotto,0,4,25,37.0,40,30,35,5,0,22,36,61.1,14,45,29,16,36,76,192,0,3330.0
Vincent Le Goff,0,3,32,37.0,75,32,56,16,3,45,62,72.6,17,29,9,20,41,116,105,1,3330.0
Marc Guéhi,0,1,22,37.0,52,27,39,11,2,26,42,61.9,16,45,24,21,45,97,134,3,3330.0
Sergi Darder,6,2,28,36.9,69,38,12,43,14,29,73,39.7,44,34,2,32,24,93,23,0,3321.0
Ezri Konsa,0,1,24,36.9,42,20,25,15,2,18,26,69.2,8,41,23,18,26,68,120,3,3321.0
Anthony Rouault,0,3,21,36.8,66,37,54,10,2,30,58,51.7,28,52,26,26,56,122,126,4,3311.9999999999995
Bruno Fernandes,8,1,27,36.8,68,42,24,25,19,30,71,42.3,41,37,5,32,25,93,40,1,3311.9999999999995
Dante,0,3,38,36.7,70,40,45,21,4,36,59,61.0,23,52,31,21,47,117,125,2,3303.0000000000005
Max Kilman,0,1,25,36.7,36,20,26,9,1,16,30,53.3,14,70,42,28,19,55,164,1,3303.0000000000005
Mohamed Salah,3,1,30,36.6,21,12,4,5,12,10,26,38.5,16,21,0,21,6,27,4,0,3294.0
Daniel Parejo,6,2,33,36.5,71,40,32,23,16,30,75,40.0,45,40,12,28,29,100,31,2,3285.0
Declan Rice,6,1,23,36.4,79,38,44,31,4,31,50,62.0,19,45,15,30,63,142,58,0,3276.0
Ben Mee,0,1,32,36.3,45,24,28,13,4,20,37,54.1,17,54,42,12,48,93,122,1,3266.9999999999995
Giovanni Di Lorenzo,0,4,28,36.2,60,29,33,19,8,25,49,51.0,24,30,9,21,30,90,60,0,3258.0000000000005
Timothy Castagne,0,1,26,36.2,87,44,53,27,7,41,84,48.8,43,50,13,37,43,130,110,0,3258.0000000000005
Jefferson Lerma,6,1,27,36.1,50,30,23,23,4,20,45,44.4,25,32,15,17,47,97,91,1,3249.0
Rico Henry,0,1,25,36.0,57,31,20,28,9,22,41,53.7,19,29,8,21,30,87,84,1,3240.0
Pascal Groß,7,1,31,36.0,59,38,23,27,9,25,55,45.5,30,32,10,22,13,72,21,1,3240.0
Lewis Dunk,0,1,30,36.0,30,19,19,9,2,18,41,43.9,23,37,27,10,34,64,81,1,3240.0
Iván Balliu,0,2,30,35.9,52,29,26,20,6,18,30,60.0,12,26,3,23,25,77,72,1,3231.0
Jarrod Bowen,5,1,25,35.9,39,16,14,11,14,16,57,28.1,41,47,9,38,36,75,25,0,3231.0
Kevin Danso,0,3,23,35.9,37,19,25,11,1,19,30,63.3,11,48,34,14,33,70,124,0,3231.0
Jubal,0,3,28,35.7,41,26,29,11,1,19,38,50.0,19,57,34,23,53,94,193,0,3213.0000000000005
Fabian Schär,0,1,30,35.6,47,22,31,13,3,24,39,61.5,15,34,19,15,52,99,139,0,3204.0
Erik Palmer-Brown,0,3,25,35.5,42,27,31,10,1,18,33,54.5,15,56,29,27,26,68,166,1,3195.0
Walace,6,4,27,35.5,82,39,42,31,9,41,90,45.6,49,47,12,35,51,133,51,1,3195.0
Danilo,0,4,31,35.4,92,62,61,23,8,52,73,71.2,21,39,20,19,47,139,114,1,3186.0
Bukayo Saka,3,1,20,35.3,63,34,22,15,26,20,44,45.5,24,38,0,38,14,77,19,0,3176.9999999999995
Robin Koch,0,1,26,35.3,53,30,32,16,5,24,56,42.9,32,44,21,23,43,96,152,1,3176.9999999999995
Jonathan David,3,3,22,35.2,24,17,6,11,7,10,27,37.0,17,20,2,18,8,32,13,0,3168.0000000000005
Rodrigo Ely,0,2,28,35.1,30,21,26,4,0,18,25,72.0,7,46,33,13,31,61,203,1,3159.0
Javi Galán,0,2,27,35.1,104,72,60,40,4,48,98,49.0,50,54,5,49,41,145,63,1,3159.0
Andrei Girotto,2,3,30,35.0,122,73,71,45,6,74,132,56.1,58,55,24,31,73,195,176,1,3150.0
Tyrone Mings,0,1,29,35.0,15,7,10,5,0,9,20,45.0,11,40,21,19,54,69,163,2,3150.0
Luis Hernández,0,2,33,35.0,33,21,25,7,1,22,36,61.1,14,31,24,7,31,64,145,0,3150.0
Unai Núñez,0,2,25,35.0,47,35,29,15,3,18,34,52.9,16,27,17,10,72,119,135,1,3150.0
Moisés Caicedo,6,1,20,34.9,100,50,41,47,12,40,68,58.8,28,43,7,36,56,156,31,3,3141.0
Sebastiano Luperto,0,4,25,34.8,33,18,24,8,1,9,20,45.0,11,54,42,12,43,76,163,1,3131.9999999999995
Pierre Højbjerg,6,1,26,34.8,56,30,28,22,6,26,67,38.8,41,46,17,29,49,105,64,1,3131.9999999999995
Arthur Theate,0,3,22,34.7,29,19,17,8,4,17,30,56.7,13,26,14,12,30,59,114,3,3123.0000000000005
Sven Botman,0,1,22,34.7,38,24,31,7,0,22,28,78.6,6,44,24,20,34,72,126,2,3123.0000000000005
Stijn Spierings,6,3,26,34.7,95,67,37,49,9,43,101,42.6,58,49,11,38,53,148,44,0,3123.0000000000005
Martin Ødegaard,6,1,23,34.7,36,23,12,14,10,14,47,29.8,33,20,5,15,6,42,12,1,3123.0000000000005
Ollie Watkins,3,1,26,34.7,19,13,3,13,3,10,27,37.0,17,21,4,17,10,29,39,0,3123.0000000000005
Alfonso Espino,0,2,30,34.7,87,56,55,20,12,48,96,50.0,48,52,11,41,48,135,99,3,3123.0000000000005
Joseph Aidoo,0,2,26,34.7,51,36,33,17,1,16,28,57.1,12,26,14,12,31,82,150,0,3123.0000000000005
Mateusz Wieteska,0,3,25,34.6,41,23,28,13,0,19,33,57.6,14,44,28,16,56,97,97,4,3114.0
Dan Burn,0,1,30,34.6,60,38,29,23,8,34,67,50.7,33,42,16,26,32,92,120,2,3114.0
Catena,0,2,27,34.5,29,14,23,4,2,13,27,48.1,14,32,25,7,28,57,159,1,3105.0
João Palhinha,6,1,27,34.5,147,83,58,65,24,71,134,53.0,63,48,5,43,46,193,61,2,3105.0
Stanislav Lobotka,6,4,27,34.5,83,44,35,35,13,43,73,58.9,30,29,7,22,23,106,16,0,3105.0
Martín Zubimendi,6,2,23,34.5,59,33,23,30,6,24,45,53.3,21,44,17,27,37,96,55,4,3105.0
Lilian Brassier,0,3,22,34.4,42,30,31,8,3,23,32,71.9,9,42,19,23,53,95,132,1,3096.0
Valentin Gendrey,0,4,22,34.4,88,57,54,25,9,40,71,56.3,31,45,4,41,37,125,89,0,3096.0
Cédric Hountondji,0,3,28,34.4,50,36,31,17,2,19,29,65.5,10,44,22,22,59,109,132,1,3096.0
Antonee Robinson,0,1,24,34.3,62,38,43,15,4,44,65,67.7,21,49,13,36,53,115,83,3,3086.9999999999995
Carlos,0,4,23,34.3,73,38,42,23,8,33,54,61.1,21,24,6,18,24,97,85,1,3086.9999999999995
Youssouf Fofana,6,3,23,34.3,81,41,31,42,8,38,74,51.4,36,50,6,44,56,137,32,1,3086.9999999999995
Benjamin Bourigeaud,8,3,28,34.1,45,29,16,23,6,21,65,32.3,44,38,3,35,31,76,32,0,3069.0
Seko Fofana,6,3,27,34.1,28,13,8,18,2,15,39,38.5,24,17,4,13,19,47,14,0,3069.0
Tommaso Augello,0,4,27,34.0,17,14,13,2,2,9,20,45.0,11,23,7,16,17,34,61,1,3060.0
Matthias Ginter,0,0,28,34.0,43,20,29,12,2,26,40,65.0,14,40,24,16,35,78,153,3,3060.0
Andre-Frank Zambo Anguissa,6,4,26,33.9,53,32,16,29,8,16,64,25.0,48,50,4,46,49,102,25,0,3051.0
Kim Min-jae,0,4,25,33.9,55,30,32,22,1,25,29,86.2,4,36,26,10,41,96,123,1,3051.0
Ben White,0,1,24,33.9,60,31,23,30,7,42,70,60.0,28,47,11,36,22,82,79,1,3051.0
Florian Sotoca,8,3,31,33.9,39,19,11,17,11,15,40,37.5,25,41,2,39,29,68,51,0,3051.0
Pau Torres,0,2,25,33.9,43,25,25,13,5,23,36,63.9,13,36,27,9,13,56,146,3,3051.0
Valentin Rongier,6,3,27,33.7,93,59,33,47,13,41,77,53.2,36,50,11,39,54,147,38,1,3033.0000000000005
Adrien Tameze,6,4,28,33.7,51,30,21,26,4,28,63,44.4,35,51,14,37,37,88,55,2,3033.0000000000005
Enzo Le Fée,6,3,22,33.6,108,64,52,40,16,43,113,38.1,70,50,5,45,34,142,38,1,3024.0
Sergej Milinković-Savić,6,4,27,33.6,58,35,22,23,13,24,67,35.8,43,50,12,38,28,86,49,0,3024.0
Rúben Neves,6,1,25,33.5,79,43,31,33,15,32,74,43.2,42,59,22,37,50,129,85,1,3015.0
Santiago Bueno,0,2,23,33.4,63,38,43,19,1,24,36,66.7,12,34,22,12,31,94,105,2,3006.0
Folarin Balogun,3,3,21,33.3,9,5,1,5,3,2,20,10.0,18,20,1,19,3,12,15,0,2996.9999999999995
Rogério,0,4,24,33.3,37,21,22,8,7,17,35,48.6,18,32,9,23,37,74,70,0,2996.9999999999995
Srđan Babić,0,2,26,33.3,28,18,20,8,0,15,32,46.9,17,34,22,12,29,57,124,1,2996.9999999999995
Granit Xhaka,6,1,29,33.3,34,27,11,18,5,16,41,39.0,25,28,10,18,15,49,45,1,2996.9999999999995
Rasmus Nicolaisen,0,3,25,33.3,48,21,34,14,0,29,46,63.0,17,58,45,13,50,98,152,0,2996.9999999999995
Castello Lukeba,0,3,19,33.2,39,23,27,8,4,21,31,67.7,10,42,24,18,75,114,105,1,2988.0000000000005
Nicolás Tagliafico,0,3,29,33.2,91,53,36,41,14,50,78,64.1,28,45,11,34,57,148,47,0,2988.0000000000005
Joselu,3,2,32,33.2,13,11,3,4,6,4,17,23.5,13,25,4,21,8,21,43,0,2988.0000000000005
Pablo Maffeo,0,2,25,33.1,75,46,54,16,5,45,78,57.7,33,38,11,27,26,101,76,0,2979.0
Enes Ünal,3,2,25,33.0,26,14,5,19,2,7,25,28.0,18,19,2,17,6,32,35,0,2970.0
Morgan Gibbs-White,8,1,22,33.0,26,14,7,7,12,11,32,34.4,21,23,4,19,14,40,15,0,2970.0
Micky van de Ven,0,0,21,33.0,45,30,26,18,1,28,39,71.8,11,42,24,18,26,71,108,2,2970.0
Felipe Anderson,3,4,29,32.9,80,50,31,41,8,31,88,35.2,57,58,6,52,31,111,27,0,2961.0
Isaac Palazón Camacho,5,2,27,32.9,45,30,11,23,11,24,66,36.4,42,42,3,39,17,62,30,0,2961.0
Marten de Roon,6,4,31,32.9,77,39,37,35,5,37,81,45.7,44,37,4,33,36,113,58,0,2961.0
Dimitris Nikolaou,0,4,23,32.9,45,32,31,10,4,25,37,67.6,12,41,26,15,27,72,82,0,2961.0
Morten Hjulmand,6,4,23,32.9,90,52,49,40,1,37,67,55.2,30,43,11,32,72,162,54,0,2961.0
Oriol Romeu,6,2,30,32.8,70,38,36,26,8,26,51,51.0,25,48,10,38,37,107,54,0,2951.9999999999995
Willi Orban,0,0,29,32.8,51,30,33,18,0,26,43,60.5,17,42,24,18,39,90,129,1,2951.9999999999995
Ivan Toney,3,1,26,32.8,23,13,4,9,10,7,23,30.4,16,24,9,15,14,37,36,0,2951.9999999999995
Lucas Tousart,6,0,25,32.7,73,38,35,28,10,27,60,45.0,33,42,6,36,48,121,75,1,2943.0000000000005
Adam Smith,0,1,31,32.7,49,29,27,19,3,29,60,48.3,31,30,13,17,25,74,81,1,2943.0000000000005
Brennan Johnson,5,1,21,32.6,34,20,18,8,8,8,28,28.6,20,30,1,29,5,39,7,1,2934.0
Bryan Cristante,7,4,27,32.6,113,62,55,49,9,55,90,61.1,35,39,10,29,18,131,53,0,2934.0
Waldemar Anton,0,0,26,32.6,49,27,27,19,3,27,51,52.9,24,44,16,28,38,87,123,2,2934.0
Vedat Muriqi,3,2,28,32.6,12,7,4,7,1,3,13,23.1,10,19,7,12,12,24,73,0,2934.0
Matteo Pessina,6,4,25,32.6,57,36,28,21,8,26,62,41.9,36,50,15,35,37,94,33,1,2934.0
Douglas Luiz,6,1,24,32.5,73,42,31,32,10,30,63,47.6,33,36,7,29,40,113,27,2,2925.0
Trent Alexander-Arnold,0,1,23,32.5,57,40,32,16,9,42,79,53.2,37,25,7,18,43,100,41,2,2925.0
Alexandre Lacazette,3,3,31,32.5,43,23,7,17,19,10,29,34.5,19,23,3,20,15,58,4,0,2925.0
Alessio Romagnoli,0,4,27,32.5,33,15,19,14,0,11,22,50.0,11,33,26,7,38,71,108,0,2925.0
Wataru Endo,6,0,29,32.5,70,37,30,31,9,38,85,44.7,47,44,6,38,26,96,63,0,2925.0
Benjamin André,6,3,31,32.4,128,74,51,60,17,65,121,53.7,56,50,8,42,47,175,60,0,2916.0
Junya Ito,3,3,29,32.4,40,20,14,15,11,13,53,24.5,40,29,1,28,8,48,4,1,2916.0
Rodri,6,1,26,32.3,67,41,28,28,11,26,52,50.0,26,40,14,26,33,100,43,1,2906.9999999999995
Bryan Mbeumo,3,1,22,32.3,26,18,5,13,8,8,42,19.0,34,24,1,23,13,39,21,0,2906.9999999999995
Tim Ream,0,1,34,32.2,30,16,15,12,3,13,26,50.0,13,45,24,21,41,71,116,2,2898.0000000000005
Salis Abdul Samed,6,3,22,32.2,46,26,18,23,5,29,52,55.8,23,38,9,29,36,82,26,0,2898.0000000000005
Jhon Lucumí,0,4,24,32.2,53,37,39,13,1,24,43,55.8,19,43,26,17,35,88,100,1,2898.0000000000005
Caio Henrique Oliveira Silva,0,3,25,32.2,74,51,42,28,4,44,76,57.9,32,28,8,20,26,100,68,1,2898.0000000000005
Lassana Coulibaly,6,4,26,32.1,84,50,42,35,7,30,73,41.1,43,35,7,28,25,109,33,2,2889.0
Tyrick Mitchell,0,1,22,32.1,71,49,43,23,5,30,53,56.6,23,48,11,37,42,113,78,0,2889.0
Son Heung-min,8,1,30,32.1,24,12,7,8,9,9,30,30.0,21,23,2,21,13,37,6,0,2889.0
Branco van den Boomen,6,3,27,32.1,71,36,26,32,13,36,89,40.4,53,27,4,23,10,81,27,2,2889.0
Samuel,5,2,22,32.1,66,43,17,37,12,26,72,36.1,46,34,0,34,18,84,16,0,2889.0
Alexis Mac Allister,6,1,23,32.1,70,39,22,40,8,34,70,48.6,36,26,2,24,22,92,10,1,2889.0
Habib Diallo,3,3,27,32.0,18,10,8,7,3,6,16,37.5,10,19,4,15,12,30,26,0,2880.0
Rani Khedira,6,0,28,32.0,60,33,21,32,7,25,50,50.0,25,33,10,23,40,100,33,0,2880.0
Marcus Rashford,3,1,24,32.0,20,10,7,8,5,9,24,37.5,15,31,4,27,7,27,14,0,2880.0
Robin Knoche,0,0,30,31.9,45,29,29,12,4,24,47,51.1,23,35,18,17,38,83,140,0,2871.0
Nahuel Molina,0,2,24,31.9,69,43,38,18,13,39,91,42.9,52,38,7,31,18,87,63,1,2871.0
Guido Rodríguez,6,2,28,31.9,115,75,59,50,6,54,101,53.5,47,58,14,44,42,157,76,1,2871.0
Jean-Clair Todibo,0,3,22,31.9,76,48,54,19,3,41,56,73.2,15,41,19,22,41,117,110,2,2871.0
Iago Aspas,3,2,34,31.9,8,4,0,4,4,3,22,13.6,19,10,1,9,7,15,23,0,2871.0
Edmond Tapsoba,0,0,23,31.9,51,30,35,12,4,30,42,71.4,12,40,17,23,36,87,109,1,2871.0
Davide Frattesi,6,4,22,31.9,63,36,24,29,10,25,44,56.8,19,27,6,21,16,79,42,0,2871.0
Álvaro García,5,2,29,31.9,49,28,21,13,15,11,33,33.3,22,41,4,37,34,83,24,1,2871.0
Dominic Solanke,5,1,24,31.8,15,9,8,3,4,5,22,22.7,17,26,7,19,6,21,46,0,2862.0
Harrison Reed,6,1,27,31.8,44,27,17,21,6,16,50,32.0,34,54,12,42,19,63,36,0,2862.0
Gianluca Mancini,0,4,26,31.8,37,19,27,9,1,18,34,52.9,16,38,17,21,46,83,67,0,2862.0
Antoine Griezmann,5,2,31,31.8,49,34,15,23,11,20,66,30.3,46,34,3,31,24,73,31,0,2862.0
Jordan Veretout,6,3,29,31.8,56,35,17,32,7,25,53,47.2,28,22,7,15,36,92,40,2,2862.0
Teun Koopmeiners,6,4,24,31.8,46,26,15,24,7,28,55,50.9,27,41,5,36,19,65,36,2,2862.0
Batista Mendy,7,3,22,31.8,70,30,34,28,8,37,53,69.8,16,38,6,32,21,91,29,2,2862.0
Chancel Mbemba,0,3,27,31.7,43,26,24,17,2,22,31,71.0,9,25,12,13,42,85,89,0,2853.0
Fran Beltrán,6,2,23,31.7,34,22,15,14,5,14,55,25.5,41,29,5,24,53,87,35,2,2853.0
Ellyes Skhiri,6,0,27,31.7,79,44,29,42,8,26,66,39.4,40,52,12,40,56,135,48,0,2853.0
Marvin Ducksch,3,0,28,31.7,8,3,2,4,2,3,16,18.8,13,13,2,11,9,17,41,1,2853.0
Lucas Robertone,6,2,25,31.6,50,28,20,21,9,28,64,43.8,36,45,7,38,46,96,46,1,2844.0
Djené,0,2,30,31.6,41,28,23,17,1,22,38,57.9,16,25,10,15,42,83,81,1,2844.0
Robert Lewandowski,3,2,33,31.6,17,11,2,5,10,7,14,50.0,7,20,0,20,2,19,14,0,2844.0
Neto Borges,0,3,25,31.5,75,45,45,20,10,46,75,61.3,29,45,11,34,41,116,62,1,2835.0
Przemysław Frankowski,2,3,27,31.5,77,51,37,31,9,39,80,48.8,41,38,6,32,41,118,42,2,2835.0
Virgil van Dijk,0,1,31,31.5,27,14,13,11,3,8,19,42.1,11,24,16,8,31,58,138,2,2835.0
Iñaki Williams,3,2,28,31.5,22,16,5,14,3,9,24,37.5,15,18,3,15,7,29,34,0,2835.0
Lionel Messi,5,3,35,31.5,26,18,1,13,12,11,27,40.7,16,11,0,11,2,28,0,0,2835.0
Vinicius Júnior,3,2,22,31.4,30,21,10,12,8,14,39,35.9,25,24,1,23,6,36,1,0,2826.0
Nico Elvedi,0,0,25,31.4,46,24,32,12,2,27,41,65.9,14,31,16,15,35,81,149,3,2826.0
Jonas Hector,0,0,32,31.4,112,66,59,43,10,66,113,58.4,47,61,9,52,39,151,74,1,2826.0
Fabiano Parisi,0,4,21,31.4,65,35,37,21,7,30,72,41.7,42,51,16,35,41,106,91,0,2826.0
Jonathan Gradit,0,3,29,31.4,62,40,30,25,7,31,53,58.5,22,40,26,14,38,100,83,0,2826.0
Lee Kangin,8,2,21,31.4,42,24,10,22,10,18,61,29.5,43,25,2,23,11,53,7,0,2826.0
Eric Dier,0,1,28,31.3,30,19,16,12,2,9,19,47.4,10,41,24,17,35,65,112,2,2817.0
Roberto Pereyra,2,4,31,31.3,36,20,21,12,3,16,44,36.4,28,20,5,15,16,52,28,0,2817.0
Angel Gomes,6,3,21,31.3,41,19,12,21,8,18,49,36.7,31,22,2,20,13,54,11,1,2817.0
Kylian Mbappé,3,3,23,31.3,10,4,0,5,5,5,16,31.3,11,5,0,5,5,15,6,0,2817.0
Óscar de Marcos,0,2,33,31.3,67,33,34,22,11,40,76,52.6,36,42,6,36,29,96,59,0,2817.0
Nehuén Pérez,0,4,22,31.3,77,40,54,20,3,39,55,70.9,16,53,23,30,35,112,106,1,2817.0
Nicolas Höfler,6,0,32,31.3,66,35,28,35,3,27,61,44.3,34,40,13,27,58,124,49,0,2817.0
Ludovic Blas,8,3,24,31.3,47,30,17,19,11,17,49,34.7,32,26,1,25,19,66,8,0,2817.0
Tomáš Souček,6,1,27,31.3,77,37,41,29,7,28,58,48.3,30,42,17,25,53,130,71,3,2817.0
Joshua Kimmich,6,0,27,31.2,78,49,24,46,8,38,72,52.8,34,36,7,29,41,119,39,2,2808.0
Emmanuel Gyasi,4,4,28,31.2,24,15,11,10,3,9,36,25.0,27,24,6,18,8,32,26,0,2808.0
Chris Smalling,0,4,32,31.2,26,15,16,10,0,13,21,61.9,8,51,36,15,43,69,123,0,2808.0
Jeffrey Gouweleeuw,0,0,31,31.1,42,27,19,17,6,24,49,49.0,25,41,23,18,50,92,141,2,2799.0
Roger Ibanez,0,4,23,31.1,67,33,38,26,3,32,48,66.7,16,30,11,19,66,133,95,2,2799.0
Robin Le Normand,0,2,25,31.1,36,23,25,9,2,14,27,51.9,13,22,14,8,33,69,93,0,2799.0
Mathias Jensen,6,1,26,31.1,70,35,28,30,12,34,97,35.1,63,54,5,49,32,102,24,1,2799.0
Martinelli,3,1,21,31.0,31,18,13,12,6,9,22,40.9,13,24,1,23,9,40,14,0,2790.0
Wout Faes,0,1,24,31.0,56,33,28,26,2,28,44,63.6,16,53,37,16,41,97,113,2,2790.0
Facundo Medina,0,3,23,30.9,31,20,16,15,0,13,35,37.1,22,25,9,16,26,57,62,1,2781.0
Emanuele Valeri,0,4,23,30.9,54,27,29,21,4,29,69,42.0,40,17,3,14,22,76,44,1,2781.0
Nemanja Gudelj,2,2,30,30.9,43,33,22,18,3,20,33,60.6,13,39,29,10,34,77,102,1,2781.0
Rafael Tolói,0,4,31,30.9,69,44,37,32,0,35,64,54.7,29,42,18,24,57,126,88,1,2781.0
Jonathan Bamba,3,3,26,30.9,37,17,12,14,11,14,45,31.1,31,36,1,35,22,59,14,0,2781.0
Joachim Andersen,0,1,26,30.9,42,22,30,12,0,16,32,50.0,16,28,13,15,24,66,188,0,2781.0
Erling Haaland,3,1,22,30.8,3,2,0,2,1,1,5,20.0,4,12,4,8,3,6,14,0,2772.0
Mattia Zaccagni,3,4,27,30.8,42,28,16,18,8,14,38,36.8,24,37,3,34,21,63,10,1,2772.0
Mehdi Bourabia,6,4,30,30.8,41,20,13,22,6,19,41,46.3,22,39,12,27,32,73,57,0,2772.0
Cheick Doucouré,6,1,22,30.8,77,46,40,33,4,29,52,55.8,23,47,13,34,56,133,48,0,2772.0
Theo Hernández,0,4,24,30.8,43,24,27,15,1,22,38,57.9,16,34,7,27,21,64,35,1,2772.0
Maximilian Arnold,6,0,28,30.7,62,31,25,28,9,28,54,51.9,26,34,11,23,26,88,65,2,2763.0
Borja Mayoral,3,2,25,30.7,9,4,7,2,0,5,31,16.1,26,18,0,18,3,12,10,0,2763.0
Fikayo Tomori,0,4,24,30.7,70,34,44,25,1,22,34,64.7,12,46,25,21,29,99,88,1,2763.0
Philip Billing,8,1,26,30.7,63,36,21,33,9,11,40,27.5,29,48,8,40,31,94,58,1,2763.0
Maxence Caqueret,6,3,22,30.7,87,54,27,38,22,43,109,39.4,66,45,3,42,39,126,27,0,2763.0
Adam Marušić,0,4,29,30.7,41,30,23,14,4,25,39,64.1,14,20,6,14,38,79,63,1,2763.0
Pierre Lees-Melou,6,3,29,30.7,97,55,55,37,5,57,123,46.3,66,48,13,35,52,149,46,1,2763.0
Antonio Raillo,0,2,30,30.7,34,21,23,11,0,10,15,66.7,5,38,29,9,31,65,158,1,2763.0
Patrick Ciurria,2,4,27,30.6,31,18,20,10,1,17,33,51.5,16,24,2,22,7,38,32,0,2754.0
Christian Günter,2,0,29,30.5,29,21,18,9,2,13,43,30.2,30,22,4,18,16,45,41,0,2745.0
Adrien Rabiot,6,4,27,30.5,65,35,31,23,11,30,57,52.6,27,37,7,30,26,91,44,1,2745.0
Michael Olise,5,1,20,30.5,58,34,28,26,4,25,60,41.7,35,46,1,45,26,84,17,0,2745.0
Jordan Ferri,6,3,30,30.4,55,35,32,19,4,30,89,33.7,59,22,6,16,26,81,21,0,2736.0
Gerard Gumbau,6,2,27,30.4,44,25,17,23,4,18,51,35.3,33,32,8,24,28,72,40,0,2736.0
Mario Götze,6,0,30,30.4,42,25,13,22,7,14,47,29.8,33,25,0,25,13,55,12,0,2736.0
Arnau Martinez,0,2,19,30.4,69,45,41,19,9,38,85,44.7,47,44,10,34,25,94,54,2,2736.0
Antonio Candreva,7,4,35,30.3,17,7,13,2,2,11,38,28.9,27,7,3,4,17,34,32,0,2727.0
Bruno Guimarães,6,1,24,30.3,78,40,27,46,5,38,65,58.5,27,28,4,24,36,114,22,1,2727.0
Nikola Vlašić,8,4,24,30.3,32,21,9,16,7,15,34,44.1,19,25,2,23,10,42,14,0,2727.0
Jaka Bijol,0,4,23,30.3,39,23,32,7,0,16,27,59.3,11,41,25,16,29,68,165,0,2727.0
Anthony Losilla,6,0,36,30.2,76,49,32,34,10,38,77,49.4,39,39,12,27,37,113,67,0,2718.0
Solly March,4,1,28,30.2,53,31,16,17,20,8,28,28.6,20,34,3,31,24,77,32,0,2718.0
Alessandro Buongiorno,0,4,23,30.2,38,25,22,16,0,16,31,51.6,15,38,19,19,60,98,105,2,2718.0
Tuta,0,0,23,30.2,53,35,27,19,7,33,57,57.9,24,47,14,33,49,102,134,2,2718.0
Jordan Ayew,5,1,30,30.2,66,41,23,20,23,21,53,39.6,32,35,4,31,15,81,31,0,2718.0
Marquinhos,0,3,28,30.2,33,25,18,12,3,18,26,69.2,8,43,27,16,23,56,83,2,2718.0
José Luis Gayà,0,2,27,30.1,80,46,61,16,3,43,74,58.1,31,28,9,19,23,103,48,0,2709.0
Sandro Tonali,6,4,22,30.1,64,41,35,24,5,27,44,61.4,17,34,9,25,25,89,26,1,2709.0
Marc-Oliver Kempf,0,0,27,30.1,44,27,29,14,1,16,22,72.7,6,42,32,10,51,95,143,0,2709.0
Harvey Barnes,5,1,24,30.1,26,14,8,14,4,14,42,33.3,28,32,1,31,8,34,12,0,2709.0
Jack Harrison,5,1,25,30.1,41,17,5,15,21,12,52,23.1,40,47,2,45,22,63,25,0,2709.0
Jeremie Frimpong,2,0,21,30.1,53,27,22,26,5,23,44,52.3,21,24,3,21,16,69,40,0,2709.0
Moussa Diaby,5,0,23,30.0,14,8,4,8,2,7,14,50.0,7,8,0,8,5,19,3,0,2700.0
Sergio Ramos,0,3,36,30.0,34,26,14,18,2,23,44,52.3,21,29,13,16,34,68,93,3,2700.0
Ethan Pinnock,0,1,29,30.0,52,28,33,12,7,18,24,75.0,6,41,31,10,35,87,215,2,2700.0
Marshall Munetsi,6,3,26,30.0,58,27,13,31,14,20,48,41.7,28,37,11,26,26,84,41,1,2700.0
Éder Militão,0,2,24,30.0,46,32,25,18,3,26,33,78.8,7,67,39,28,42,88,104,2,2700.0
Iyenoma Udogie,0,4,19,30.0,71,45,42,24,5,34,59,57.6,25,34,6,28,36,107,25,0,2700.0
John McGinn,8,1,27,29.9,66,36,27,29,10,34,71,47.9,37,43,4,39,24,90,19,0,2691.0
Obite N'Dicka,0,0,22,29.9,25,18,10,11,4,18,32,56.3,14,47,19,28,31,56,150,0,2691.0
Christopher Jullien,0,3,29,29.9,46,28,29,14,3,28,51,54.9,23,35,18,17,43,89,114,1,2691.0
Andreas Pereira,6,1,26,29.9,18,9,3,6,9,8,33,24.2,25,21,3,18,6,24,8,0,2691.0
Jude Bellingham,6,0,19,29.9,76,42,28,34,14,34,51,66.7,17,51,4,47,35,111,30,0,2691.0
David García,0,2,28,29.8,34,20,22,12,0,19,22,86.4,3,28,13,15,45,79,151,0,2682.0
Alexis Sánchez,5,3,33,29.8,27,17,5,16,6,3,24,12.5,21,14,0,14,5,32,6,0,2682.0
Jonas Hofmann,5,0,30,29.8,31,16,17,8,6,15,52,28.8,37,36,2,34,16,47,21,0,2682.0
Jeremy Toljan,0,4,27,29.7,36,23,17,14,5,22,33,66.7,11,31,14,17,18,54,60,1,2673.0
Alexander Djiku,0,3,27,29.7,53,36,37,16,0,26,46,56.5,20,45,19,26,66,119,151,3,2673.0
Fabinho,6,1,28,29.7,65,38,18,40,7,24,62,38.7,38,38,11,27,37,102,40,0,2673.0
Ricardo Rodríguez,0,4,29,29.7,54,33,30,17,7,28,42,66.7,14,30,15,15,38,92,61,0,2673.0
Pervis Estupiñán,0,1,24,29.7,61,31,36,19,6,35,60,58.3,25,30,8,22,37,98,37,1,2673.0
Leandro Cabrera,0,2,31,29.7,46,24,34,12,0,28,43,65.1,15,37,23,14,43,89,114,2,2673.0
Joelinton,8,1,25,29.6,70,49,36,26,8,26,62,41.9,36,52,7,45,48,118,39,0,2664.0
Rominigue Kouamé,6,3,25,29.6,44,27,28,14,2,17,41,41.5,24,32,11,21,49,93,46,1,2664.0
Mama Samba Baldé,3,3,26,29.6,46,21,14,21,11,13,28,46.4,15,30,3,27,10,56,13,0,2664.0
Domingos Duarte,0,2,27,29.5,26,18,21,5,0,19,26,73.1,7,29,23,6,39,65,145,0,2655.0
M'Bala Nzola,3,4,25,29.5,12,5,0,6,6,3,9,33.3,6,20,6,14,7,19,21,0,2655.0
Vitaliy Mykolenko,0,1,23,29.5,58,34,36,19,3,28,51,54.9,23,50,16,34,46,104,99,0,2655.0
Martin Valjent,0,2,26,29.5,35,27,22,12,1,19,28,67.9,9,39,21,18,29,64,137,0,2655.0
Bafodé Diakité,0,3,21,29.5,54,35,23,24,7,32,57,56.1,25,37,8,29,17,71,58,0,2655.0
Nico Williams,3,2,20,29.5,31,16,10,15,6,19,41,46.3,22,40,2,38,8,39,14,1,2655.0
Haris Belkebla,6,3,28,29.5,80,48,35,40,5,44,85,51.8,41,32,6,26,52,132,21,3,2655.0
Yoann Salmier,0,3,29,29.4,51,29,34,12,5,21,35,60.0,14,34,19,15,39,90,124,0,2646.0
Djibril Sow,6,0,25,29.4,41,25,13,25,3,22,44,50.0,22,22,4,18,28,69,23,0,2646.0
Kyle Walker-Peters,0,1,25,29.4,61,32,34,24,3,22,42,52.4,20,47,8,39,27,88,52,0,2646.0
Carlos Clerc,2,2,30,29.3,75,51,55,16,4,31,50,62.0,19,29,7,22,28,103,94,1,2637.0
Ethan Ampadu,2,4,21,29.3,66,37,33,28,5,17,41,41.5,24,48,23,25,36,102,98,0,2637.0
Leonardo Balerdi,0,3,23,29.3,57,37,43,12,2,32,45,71.1,13,48,29,19,63,120,91,1,2637.0
Gleison Bremer,0,4,25,29.3,29,20,23,5,1,19,26,73.1,7,44,22,22,42,71,120,2,2637.0
Eberechi Eze,8,1,24,29.3,42,24,17,18,7,18,38,47.4,20,22,0,22,13,55,10,0,2637.0
Jacob Ramsey,8,1,21,29.3,69,39,23,35,11,32,69,46.4,37,48,8,40,23,92,34,0,2637.0
Randal Kolo Muani,3,0,23,29.2,14,10,3,3,8,1,9,11.1,8,19,2,17,3,17,13,0,2628.0
Nélson Semedo,0,1,28,29.2,71,42,48,19,4,33,64,51.6,31,42,15,27,29,100,83,2,2628.0
Philipp Hofmann,3,0,29,29.2,18,11,0,13,5,5,12,41.7,7,20,8,12,6,24,48,0,2628.0
Angeliño,0,0,25,29.1,40,24,19,18,3,23,37,62.2,14,32,6,26,25,65,67,0,2619.0
Anthony Jung,1,0,30,29.1,46,27,19,20,7,31,58,53.4,27,30,6,24,22,68,63,0,2619.0
Isak Hien,0,4,23,29.0,73,36,54,19,0,38,61,62.3,23,40,17,23,31,104,92,1,2610.0
Nicolò Barella,6,4,25,29.0,49,25,17,26,6,28,53,52.8,25,29,5,24,12,61,12,0,2610.0
Kouadio Koné,6,0,21,29.0,74,39,37,33,4,24,47,51.1,23,44,12,32,32,106,21,0,2610.0
Jaume Costa,0,2,34,28.9,50,34,26,17,7,29,51,56.9,22,13,5,8,22,72,44,1,2601.0
Johan Gastien,6,3,34,28.9,62,34,30,23,9,38,111,34.2,73,37,7,30,36,98,25,1,2601.0
Valentín Castellanos,3,2,23,28.9,12,5,2,7,3,0,18,0.0,18,22,2,20,6,18,26,0,2601.0
Kevin Stöger,6,0,28,28.9,84,45,38,32,14,31,94,33.0,63,27,4,23,26,110,21,1,2601.0
Marius Bülter,5,0,29,28.9,22,11,8,7,7,12,32,37.5,20,34,1,33,10,32,20,0,2601.0
José Fonte,0,3,38,28.8,23,17,18,4,1,10,21,47.6,11,27,14,13,25,48,112,2,2592.0
Jonathan Clauss,0,3,29,28.8,46,28,21,16,9,23,52,44.2,29,29,4,25,31,77,40,2,2592.0
Marco Friedl,0,0,24,28.8,62,46,40,22,0,41,68,60.3,27,46,17,29,58,120,127,1,2592.0
Falaye Sacko,0,3,27,28.7,46,25,25,15,6,32,51,62.7,19,43,14,29,33,79,75,1,2583.0
Ridle Baku,1,0,24,28.7,50,26,29,17,4,32,58,55.2,26,44,6,38,21,71,59,0,2583.0
Andrew Robertson,0,1,28,28.7,38,21,12,16,10,21,41,51.2,20,32,5,27,18,56,50,3,2583.0
Mikel Vesga,6,2,29,28.6,57,35,21,31,5,25,68,36.8,43,39,8,31,36,93,39,3,2574.0
Idrissa Gana Gueye,6,1,32,28.6,97,57,49,35,13,31,60,51.7,29,50,12,38,56,153,34,3,2574.0
Lautaro Martínez,3,4,24,28.6,25,14,3,15,7,7,23,30.4,16,31,1,30,13,38,16,1,2574.0
Oumar Gonzalez,0,3,24,28.6,51,28,34,13,4,23,37,62.2,14,32,11,21,52,103,82,0,2574.0
Filip Kostić,1,4,29,28.5,41,26,17,20,4,21,47,44.7,26,30,4,26,16,57,32,0,2565.0
Christoph Baumgartner,8,0,22,28.5,36,19,12,17,7,9,52,17.3,43,57,5,52,15,51,19,1,2565.0
Kai Havertz,5,1,23,28.5,34,16,4,20,10,10,30,33.3,20,28,0,28,7,41,41,0,2565.0
Florian Lejeune,0,2,31,28.5,28,17,19,8,1,17,25,68.0,8,24,16,8,15,43,123,0,2565.0
Victor Osimhen,3,4,23,28.5,10,6,1,2,7,0,7,0.0,7,6,1,5,6,16,29,0,2565.0
Kenny Tete,0,1,26,28.5,83,46,41,29,13,38,50,76.0,12,48,17,31,52,135,81,1,2565.0
Jean-Charles Castelletto,0,3,27,28.5,43,26,29,12,2,22,36,61.1,14,35,22,13,58,101,90,0,2565.0
Hiroki Ito,0,0,23,28.5,40,29,24,14,2,18,35,51.4,17,38,17,21,40,80,94,0,2565.0
Luke Shaw,0,1,27,28.4,55,36,31,22,2,32,45,71.1,13,51,17,34,36,91,55,2,2556.0
Maya Yoshida,0,0,33,28.4,34,22,19,13,2,18,29,62.1,11,40,29,11,46,80,132,2,2556.0
Óscar Gil,0,2,25,28.4,63,37,38,16,9,32,61,52.5,29,51,18,33,31,94,55,1,2556.0
Joe Willock,6,1,22,28.4,51,30,13,26,12,25,58,43.1,33,54,8,46,25,76,17,0,2556.0
Sheraldo Becker,3,0,27,28.4,15,5,1,7,7,2,11,18.2,9,13,1,12,3,18,7,1,2556.0
Óscar Valentín,6,2,27,28.4,92,51,29,50,13,46,121,38.0,75,60,9,51,44,136,30,0,2556.0
Tomás Rincón,6,4,34,28.4,56,27,22,26,8,29,61,47.5,32,37,7,30,30,86,18,0,2556.0
Timo Hübers,0,0,26,28.4,43,28,35,8,0,24,52,46.2,28,27,13,14,58,101,153,0,2556.0
Pierre Kalulu,0,4,22,28.3,57,39,33,21,3,28,42,66.7,14,41,17,24,41,98,56,1,2547.0
Téji Savanier,6,3,30,28.3,46,30,16,19,11,23,70,32.9,47,30,2,28,30,76,12,1,2547.0
Koke,6,2,30,28.3,55,38,23,25,7,28,72,38.9,44,35,13,22,20,75,19,0,2547.0
Cristiano Biraghi,0,4,29,28.3,65,38,29,29,7,32,65,49.2,33,32,7,25,14,79,42,1,2547.0
Lorenzo Pellegrini,6,4,26,28.3,52,29,24,24,4,22,48,45.8,26,27,4,23,26,78,22,0,2547.0
Khéphren Thuram,6,3,21,28.3,51,25,22,23,6,19,43,44.2,24,33,13,20,38,89,34,0,2547.0
Franck Honorat,5,3,25,28.2,41,29,20,8,13,19,34,55.9,15,22,2,20,21,62,18,0,2538.0
Igor Zubeldia,0,2,25,28.2,35,18,28,7,0,25,35,71.4,10,23,17,6,21,56,93,0,2538.0
Karim Onisiwo,5,0,30,28.2,19,12,3,10,6,4,21,19.0,17,19,0,19,2,21,7,0,2538.0
Răzvan Marin,6,4,26,28.2,44,22,22,21,1,19,40,47.5,21,29,11,18,14,58,33,0,2538.0
Frenkie de Jong,6,2,25,28.2,46,26,16,21,9,17,41,41.5,24,11,1,10,35,81,22,1,2538.0
Domingos André Ribeiro Almeida,6,2,22,28.2,66,42,23,32,11,26,57,45.6,31,26,0,26,20,86,16,1,2538.0
Stefan Posch,0,4,25,28.1,81,43,41,29,11,44,75,58.7,31,44,15,29,35,116,69,0,2529.0
Hamari Traoré,0,3,30,28.1,48,32,26,15,7,28,52,53.8,24,33,7,26,38,86,64,0,2529.0
Oihan Sancet,6,2,22,28.1,27,16,2,19,6,11,37,29.7,26,10,0,10,4,31,9,1,2529.0
Rémy Cabella,8,3,32,28.1,64,37,21,28,15,29,64,45.3,35,41,5,36,17,81,7,1,2529.0
Jeffrey Schlupp,8,1,29,28.1,66,46,28,29,9,22,43,51.2,21,39,8,31,23,89,38,0,2529.0
Gavi,8,2,17,28.1,47,31,7,30,10,21,55,38.2,34,32,5,27,18,65,22,0,2529.0
Mitchell Weiser,1,0,28,28.0,71,43,38,24,9,38,75,50.7,37,50,7,43,28,99,38,1,2520.0
Khvicha Kvaratskhelia,3,4,21,28.0,43,23,12,8,23,17,43,39.5,26,20,0,20,5,48,6,1,2520.0
Boulaye Dia,5,4,25,28.0,12,5,3,6,3,2,7,28.6,5,10,0,10,7,19,27,1,2520.0
Sean Longstaff,6,1,24,28.0,42,21,16,20,6,20,52,38.5,32,35,8,27,16,58,23,0,2520.0
Elvis Rexhbeçaj,6,0,24,28.0,51,30,18,24,9,29,59,49.2,30,40,13,27,17,68,40,0,2520.0
Loïs Openda,3,3,22,28.0,11,9,2,6,3,2,13,15.4,11,9,0,9,2,13,6,0,2520.0
Amine Gouiri,5,3,22,28.0,42,25,14,16,12,14,33,42.4,19,21,0,21,12,54,10,0,2520.0
Tom Krauß,6,0,21,27.9,112,68,39,62,11,51,100,51.0,49,39,6,33,36,148,35,0,2511.0
Marcus Thuram,3,0,24,27.9,14,7,3,6,5,6,13,46.2,7,20,3,17,6,20,22,0,2511.0
Elye Wahi,3,3,19,27.9,9,3,2,3,4,5,14,35.7,9,14,2,12,3,12,5,0,2511.0
Germán Pezzella,0,2,31,27.9,41,28,32,9,0,26,38,68.4,12,32,15,17,50,91,129,1,2511.0
Jean-Kevin Duverne,0,3,25,27.9,72,38,44,24,4,42,73,57.5,31,33,5,28,28,100,65,1,2511.0
Demarai Gray,5,1,26,27.9,33,24,9,14,10,17,31,54.8,14,23,3,20,13,46,18,0,2511.0
Jerdy Schouten,6,4,25,27.9,63,38,28,33,2,27,49,55.1,22,40,17,23,40,103,43,1,2511.0
Federico Valverde,8,2,24,27.8,31,20,14,11,6,13,26,50.0,13,31,4,27,17,48,15,0,2502.0
Philipp Lienhart,0,0,26,27.8,29,18,19,10,0,13,27,48.1,14,29,15,14,35,64,97,0,2502.0
Dwight McNeil,5,1,22,27.8,64,41,35,14,15,27,62,43.5,35,46,7,39,31,95,41,0,2502.0
Gaëtan Laborde,3,3,28,27.8,45,25,13,17,15,18,40,45.0,22,27,2,25,9,54,13,0,2502.0
Nabil Bentaleb,6,3,27,27.7,74,40,31,35,8,36,61,59.0,25,33,11,22,44,118,29,3,2493.0
Mikel Merino,6,2,26,27.7,77,49,28,33,16,31,62,50.0,31,38,8,30,20,97,51,1,2493.0
Brendan Chardonnet,0,3,27,27.7,45,27,27,18,0,20,38,52.6,18,40,19,21,63,108,86,1,2493.0
Miguel Almirón,3,1,28,27.7,46,30,16,19,11,18,42,42.9,24,25,2,23,10,56,17,0,2493.0
Mounaim El Idrissy,3,3,23,27.7,32,19,5,20,7,10,36,27.8,26,22,0,22,13,45,20,0,2493.0
Yan Valery,0,3,23,27.7,54,39,28,20,6,20,37,54.1,17,35,15,20,34,88,82,0,2493.0
Marcos Senesi,0,1,25,27.7,50,35,28,22,0,23,43,53.5,20,38,20,18,43,93,146,2,2493.0
Cengiz Ünder,7,3,25,27.7,37,19,15,13,9,13,34,38.2,21,18,2,16,18,55,13,0,2493.0
Charles Pickel,6,4,25,27.6,55,23,25,26,4,32,57,56.1,25,37,5,32,24,79,36,1,2484.0
Amadou Onana,6,1,20,27.6,72,43,24,42,6,30,42,71.4,12,25,6,19,37,109,39,0,2484.0
Azor Matusiwa,6,3,24,27.6,66,41,30,29,7,36,61,59.0,25,37,11,26,46,112,52,0,2484.0
Jonathan Tah,0,0,26,27.6,25,12,21,4,0,12,18,66.7,6,30,18,12,40,65,118,0,2484.0
Ramy Bensebaini,0,0,27,27.6,34,21,21,10,3,26,39,66.7,13,44,14,30,36,70,98,1,2484.0
James Maddison,8,1,25,27.6,51,26,25,19,7,19,50,38.0,31,19,1,18,13,64,6,1,2484.0
Thomas Partey,6,1,29,27.6,70,40,20,35,15,25,52,48.1,27,26,5,21,28,98,41,1,2484.0
Pablo Marí,0,4,28,27.6,37,19,29,7,1,17,26,65.4,9,22,14,8,31,68,111,3,2484.0
Rodrigo Becão,0,4,26,27.6,70,36,50,17,3,40,53,75.5,13,44,24,20,26,96,68,2,2484.0
Antonino Gallo,0,4,22,27.6,56,36,35,12,9,38,57,66.7,19,37,6,31,13,69,71,0,2484.0
Bobby Reid,4,1,29,27.5,42,24,14,14,14,16,34,47.1,18,25,3,22,20,62,28,1,2475.0
Niclas Füllkrug,3,0,29,27.5,9,4,0,6,3,3,13,23.1,10,13,4,9,1,10,24,0,2475.0
Alejandro Balde,0,2,18,27.5,42,30,22,16,4,24,41,58.5,17,25,3,22,12,54,17,1,2475.0
Lucas Torró,6,2,28,27.5,48,32,28,15,5,18,42,42.9,24,24,3,21,42,90,64,1,2475.0
Zakaria Aboukhlal,5,3,22,27.5,33,23,13,9,11,14,45,31.1,31,18,1,17,22,55,23,0,2475.0
Matheus Nunes,6,1,23,27.4,67,43,36,22,9,28,61,45.9,33,35,4,31,16,83,35,2,2466.0
Lucas Boyé,3,2,26,27.4,36,16,12,16,8,17,35,48.6,18,33,5,28,15,51,46,0,2466.0
Rubén Sobrino,8,2,30,27.4,55,37,29,17,9,23,56,41.1,33,33,3,30,24,79,20,1,2466.0
Armando Izzo,0,4,30,27.4,73,50,44,27,2,29,45,64.4,16,29,17,12,50,123,87,1,2466.0
Aleksandr Golovin,8,3,26,27.4,62,36,19,32,11,28,72,38.9,44,28,1,27,37,99,10,0,2466.0
Joris Chotard,6,3,20,27.3,64,34,37,23,4,40,78,51.3,38,40,11,29,40,104,42,1,2457.0
Moi Gómez,8,2,28,27.3,26,17,9,14,3,15,32,46.9,17,15,3,12,10,36,5,1,2457.0
Alidu Seidu,0,3,22,27.3,52,31,35,14,3,31,51,60.8,20,28,14,14,52,104,50,2,2457.0
Jordan Lotomba,0,3,23,27.3,65,38,33,24,8,31,48,64.6,17,38,11,27,32,97,53,0,2457.0
Martin Braithwaite,5,2,31,27.3,12,2,2,4,6,5,14,35.7,9,10,0,10,5,17,11,0,2457.0
Mehdi Léris,7,4,24,27.3,63,46,30,24,9,23,55,41.8,32,38,6,32,27,90,34,0,2457.0
Piero Hincapié,0,0,20,27.3,51,34,28,20,3,25,38,65.8,13,41,20,21,31,82,83,1,2457.0
Mohamed Youssouf,0,3,34,27.3,72,44,41,24,7,38,61,62.3,23,32,8,24,65,137,70,0,2457.0
Melvin Bard,0,3,21,27.3,96,60,61,29,6,59,89,66.3,30,35,4,31,64,160,40,1,2457.0
Iñigo Ruiz de Galarreta,6,2,28,27.2,54,38,27,23,4,20,52,38.5,32,26,9,17,30,84,19,0,2448.0
Amir Rrahmani,0,4,28,27.2,33,18,20,13,0,17,26,65.4,9,36,20,16,14,47,79,1,2448.0
Vincent Marchetti,6,3,25,27.2,55,26,29,19,7,25,68,36.8,43,23,3,20,19,74,31,0,2448.0
Mouctar Diakhaby,0,2,25,27.2,30,16,19,11,0,13,20,65.0,7,30,17,13,20,50,111,2,2448.0
Santi Comesaña,6,2,25,27.2,71,44,24,41,6,38,82,46.3,44,39,3,36,32,103,17,0,2448.0
Omar Mascarell,7,2,29,27.2,53,26,32,19,2,31,64,48.4,33,51,19,32,45,98,54,1,2448.0
Yeremi Pino,5,2,19,27.2,62,38,25,20,17,21,56,37.5,35,41,4,37,15,77,36,0,2448.0
Dominik Szoboszlai,8,0,21,27.2,45,28,12,20,13,17,42,40.5,25,43,2,41,17,62,27,0,2448.0
Manuel Locatelli,6,4,24,27.2,59,33,26,23,10,30,53,56.6,23,50,22,28,27,86,59,0,2448.0
Vitinha,6,3,22,27.2,58,25,21,27,10,27,83,32.5,56,27,4,23,25,83,15,0,2448.0
Jon Moncayola,7,2,24,27.2,55,39,24,22,9,30,76,39.5,46,37,5,32,17,72,32,2,2448.0
Maximilian Eggestein,6,0,25,27.2,51,29,21,24,6,17,35,48.6,18,37,8,29,36,87,27,0,2448.0
Ivan Ordets,0,0,30,27.2,31,19,21,9,1,16,28,57.1,12,34,17,17,57,88,139,0,2448.0
Nicolò Casale,0,4,24,27.1,42,20,28,14,0,22,34,64.7,12,25,17,8,17,59,73,1,2439.0
Luis Alberto,6,4,29,27.1,49,29,18,20,11,23,72,31.9,49,35,6,29,9,58,4,0,2439.0
Takefusa Kubo,5,2,21,27.1,44,26,18,16,10,16,38,42.1,22,29,1,28,9,53,4,0,2439.0
Gedeon Kalulu,0,3,24,27.1,64,34,43,14,7,30,48,62.5,18,32,3,29,28,92,79,2,2439.0
Edimilson Fernandes,0,0,26,27.1,35,25,26,5,4,18,34,52.9,16,37,16,21,54,89,87,2,2439.0
Gianluca Caprari,8,4,29,27.1,16,6,3,11,2,8,26,30.8,18,22,1,21,8,24,3,0,2439.0
Gabriel Strefezza,5,4,25,27.1,50,24,18,20,12,27,53,50.9,26,36,3,33,16,66,15,0,2439.0
William Carvalho,6,2,30,27.1,43,27,18,23,2,17,44,38.6,27,27,6,21,16,59,22,0,2439.0
Rayan Raveloson,2,3,25,27.0,38,23,21,16,1,23,33,69.7,10,43,12,31,39,77,70,0,2430.0
Xavier Chavalerin,6,3,31,27.0,82,50,39,30,13,27,71,38.0,44,31,8,23,41,123,24,0,2430.0
Benjamin Pavard,0,0,26,27.0,70,41,36,26,8,36,48,75.0,12,35,16,19,44,114,83,0,2430.0
Vinicius Souza,6,2,23,27.0,99,66,41,45,13,33,59,55.9,26,31,14,17,48,147,50,1,2430.0
Jules Koundé,0,2,23,27.0,37,23,18,13,6,21,31,67.7,10,24,9,15,19,56,61,3,2430.0
Antonio Sanabria,3,4,26,27.0,11,5,3,3,5,1,7,14.3,6,9,2,7,4,15,7,0,2430.0
Ritsu Doan,8,0,24,26.9,61,29,19,29,13,25,54,46.3,29,40,1,39,14,75,12,0,2421.0
Francesco Acerbi,0,4,34,26.9,33,19,22,7,4,20,27,74.1,7,25,18,7,41,74,85,2,2421.0
Benno Schmitz,0,0,27,26.9,64,42,31,28,5,42,82,51.2,40,34,4,30,26,90,57,0,2421.0
Rafael Leão,5,4,23,26.9,8,7,2,3,3,6,14,42.9,8,9,2,7,15,23,8,0,2421.0
Koffi Djidji,0,4,29,26.9,50,25,32,17,1,18,32,56.3,14,29,14,15,34,84,72,0,2421.0
Kevin De Bruyne,6,1,31,26.9,28,12,3,12,13,14,39,35.9,25,27,2,25,9,37,10,0,2421.0
Jean-Ricner Bellegarde,8,3,24,26.9,47,25,15,21,11,11,25,44.0,14,26,3,23,26,73,22,0,2421.0
José María Giménez,0,2,27,26.9,43,25,28,14,1,24,35,68.6,11,37,17,20,24,67,138,1,2421.0
Vincenzo Grifo,8,0,29,26.8,29,16,6,15,8,13,31,41.9,18,18,1,17,19,48,19,0,2412.0
Danilo Pereira,2,3,30,26.8,32,17,15,14,3,19,26,73.1,7,26,19,7,36,68,59,1,2412.0
William Saliba,0,1,21,26.8,34,20,23,9,2,15,18,83.3,3,13,10,3,19,53,85,4,2412.0
Antonio Rüdiger,0,2,29,26.8,18,16,12,5,1,14,23,60.9,9,23,13,10,19,37,74,0,2412.0
Emi Buendía,8,1,25,26.8,52,23,20,20,12,21,74,28.4,53,20,2,18,20,72,17,0,2412.0
Yuri Berchiche,0,2,32,26.7,56,32,28,20,8,35,59,59.3,24,37,12,25,40,96,59,1,2403.0
Brian Oliván,0,2,28,26.7,47,27,30,12,5,17,26,65.4,9,26,6,20,22,69,67,0,2403.0
Marvin Plattenhardt,0,0,30,26.7,43,33,24,15,4,29,47,61.7,18,25,11,14,15,58,82,0,2403.0
Samuel Moutoussamy,6,3,25,26.7,64,34,27,28,9,26,76,34.2,50,23,2,21,24,88,15,0,2403.0
Sergio Canales,5,2,31,26.7,25,14,10,8,7,14,33,42.4,19,18,0,18,14,39,8,0,2403.0
Sergio Camello,3,2,21,26.7,16,10,3,9,4,5,17,29.4,12,9,1,8,2,18,26,0,2403.0
Matthijs de Ligt,0,0,22,26.7,32,23,15,16,1,15,24,62.5,9,31,20,11,23,55,85,0,2403.0
Brais Méndez,6,2,25,26.7,58,34,18,30,10,24,64,37.5,40,27,3,24,12,70,14,1,2403.0
Robert Andrich,6,0,27,26.7,61,38,30,27,4,26,45,57.8,19,27,9,18,42,103,55,2,2403.0
Yohann Magnin,6,3,25,26.7,89,54,37,45,7,54,106,50.9,52,50,12,38,25,114,46,0,2403.0
Arnaud Nordin,3,3,24,26.7,26,14,10,12,4,12,28,42.9,16,19,1,18,14,40,7,0,2403.0
Julian Brandt,8,0,26,26.6,29,20,6,14,9,12,43,27.9,31,23,0,23,15,44,9,1,2394.0
Stefan Bell,0,0,30,26.6,43,28,32,10,1,22,44,50.0,22,42,15,27,44,87,133,0,2394.0
Javi Sánchez,0,2,25,26.6,43,26,27,15,1,17,26,65.4,9,32,22,10,46,89,116,0,2394.0
Dodi Lukebakio,5,0,24,26.6,18,11,7,8,3,6,27,22.2,21,23,5,18,13,31,17,0,2394.0
Miguel Gutiérrez,0,2,21,26.6,41,23,23,13,5,23,37,62.2,14,23,5,18,18,59,42,1,2394.0
Alexander Sørloth,3,2,26,26.5,18,9,3,6,9,7,14,50.0,7,15,1,14,2,20,26,1,2385.0
Andrej Kramarić,8,0,31,26.5,5,2,2,1,2,1,11,9.1,10,14,2,12,6,11,13,0,2385.0
Ozan Kabak,0,0,22,26.5,51,34,27,21,3,17,30,56.7,13,35,23,12,45,96,83,0,2385.0
Emmanuel Agbadou,0,3,25,26.5,71,49,53,16,2,42,65,64.6,23,30,14,16,32,103,107,3,2385.0
Alexis Blin,6,4,25,26.4,69,39,27,33,9,38,73,52.1,35,55,15,40,34,103,74,0,2376.0
Daniel Vivian,0,2,23,26.4,57,32,36,16,5,36,45,80.0,9,27,14,13,24,81,90,3,2376.0
Rodrygo,5,2,21,26.4,17,10,3,7,7,4,23,17.4,19,23,0,23,8,25,5,0,2376.0
Brenden Aaronson,8,1,21,26.4,45,18,16,22,7,15,46,32.6,31,43,3,40,5,50,6,1,2376.0
Cristian Romero,0,1,24,26.3,68,36,42,24,2,29,46,63.0,17,40,18,22,44,112,102,3,2367.0
Borja Iglesias,3,2,29,26.3,8,4,3,3,2,2,13,15.4,11,9,1,8,1,9,17,0,2367.0
Kelvin Amian,0,4,24,26.3,54,32,33,12,9,24,31,77.4,7,34,12,22,22,76,87,1,2367.0
Hakan Çalhanoğlu,6,4,28,26.3,48,27,17,26,5,16,43,37.2,27,30,5,25,25,73,13,1,2367.0
Ermedin Demirović,5,0,24,26.3,31,14,9,12,10,9,22,40.9,13,31,4,27,14,45,37,0,2367.0
Soualiho Meïté,6,4,28,26.3,47,31,25,15,7,22,46,47.8,24,27,6,21,27,74,36,0,2367.0
Manolo Gabbiadini,5,4,30,26.2,23,15,8,9,6,9,23,39.1,14,16,2,14,6,29,25,0,2358.0
Alex Král,6,0,24,26.2,34,24,10,22,2,17,37,45.9,20,31,6,25,17,51,53,0,2358.0
Moses Simon,5,3,27,26.1,18,9,6,7,5,7,15,46.7,8,14,1,13,11,29,3,0,2349.0
Luca Caldirola,0,4,31,26.1,26,14,19,4,3,13,26,50.0,13,32,18,14,25,51,66,1,2349.0
Dayot Upamecano,0,0,23,26.1,65,37,43,22,0,28,45,62.2,17,26,6,20,27,92,71,4,2349.0
İlkay Gündoğan,6,1,31,26.1,30,18,7,13,10,12,33,36.4,21,18,3,15,20,50,13,0,2349.0
Rony Lopes,8,3,26,26.1,24,12,6,15,3,7,31,22.6,24,14,2,12,9,33,10,0,2349.0
Thijs Dallinga,3,3,21,26.1,8,6,2,2,4,1,13,7.7,12,17,3,14,3,11,20,0,2349.0
Nuno Tavares,2,3,22,26.1,56,30,19,24,13,28,55,50.9,27,32,4,28,15,71,25,0,2349.0
Thiago Silva,0,1,37,26.1,41,27,24,17,0,21,31,67.7,10,38,29,9,34,75,111,2,2349.0
Sergi Gómez,0,2,30,26.0,29,16,20,9,0,18,22,81.8,4,33,19,14,27,56,125,1,2340.0
Florian Kainz,8,0,29,26.0,21,10,7,12,2,8,26,30.8,18,27,6,21,32,53,30,1,2340.0
Youri Tielemans,6,1,25,26.0,66,39,27,30,9,23,61,37.7,38,35,8,27,28,94,24,1,2340.0
Aleix García,6,2,25,26.0,37,20,9,18,10,15,33,45.5,18,24,8,16,31,68,35,1,2340.0
Javi Puado,5,2,24,26.0,20,11,12,5,3,12,28,42.9,16,12,2,10,10,30,14,0,2340.0
Laurent Abergel,6,3,29,26.0,92,52,59,30,3,39,92,42.4,53,47,8,39,34,126,39,0,2340.0
Fares Chaïbi,5,3,19,26.0,31,18,8,15,8,17,50,34.0,33,38,5,33,19,50,36,1,2340.0
Samuel Chukwueze,5,2,23,26.0,14,7,7,2,5,7,23,30.4,16,13,0,13,12,26,16,0,2340.0
Sandi Lovrić,6,4,24,26.0,40,18,16,16,8,25,43,58.1,18,25,2,23,26,66,21,0,2340.0
Sergio Busquets,6,2,34,26.0,58,26,24,26,8,29,51,56.9,22,32,6,26,27,85,36,2,2340.0
Perr Schuurs,0,4,22,25.9,51,25,29,17,5,14,26,53.8,12,28,16,12,28,79,102,0,2331.0
Dodô,0,4,23,25.9,40,22,20,14,6,22,46,47.8,24,26,2,24,25,65,37,0,2331.0
Giorgio Scalvini,0,4,18,25.9,54,29,30,18,6,29,55,52.7,26,36,13,23,56,110,57,2,2331.0
Martin Erlic,0,4,24,25.9,27,16,18,8,1,10,23,43.5,13,36,23,13,31,58,120,1,2331.0
Yeray Álvarez,0,2,27,25.9,34,23,26,7,1,24,31,77.4,7,23,13,10,48,82,101,0,2331.0
Kaoru Mitoma,5,1,25,25.8,44,27,15,16,13,20,41,48.8,21,25,0,25,17,61,10,0,2322.0
Lewis Ferguson,8,4,22,25.7,44,25,16,20,8,20,40,50.0,20,22,7,15,19,63,25,0,2313.0
Yannick Carrasco,2,2,28,25.7,35,14,21,10,4,23,54,42.6,31,23,1,22,12,47,19,0,2313.0
Marc Roca,6,1,25,25.7,66,40,27,34,5,20,65,30.8,45,34,10,24,23,89,24,2,2313.0
Cédric Brunner,0,0,28,25.7,39,27,26,11,2,30,45,66.7,15,24,7,17,43,82,79,0,2313.0
Leonardo Sernicola,0,4,25,25.7,45,33,25,13,7,29,43,67.4,14,23,6,17,38,83,55,0,2313.0
Kike Pérez,6,2,25,25.6,67,33,30,32,5,25,68,36.8,43,26,7,19,20,87,28,0,2304.0
Gonzalo Plata,3,2,21,25.6,66,35,31,24,11,23,70,32.9,47,40,0,40,12,78,10,1,2304.0
Kiernan Dewsbury-Hall,6,1,23,25.6,53,29,14,34,5,19,47,40.4,28,55,13,42,28,81,21,0,2304.0
Álex Berenguer,3,2,27,25.5,58,37,17,25,16,23,60,38.3,37,37,4,33,10,68,6,0,2295.0
Dominik Kohr,6,0,28,25.5,59,33,23,31,5,29,61,47.5,32,46,9,37,34,93,26,1,2295.0
Nicolás Domínguez,6,4,24,25.5,79,49,34,33,12,39,76,51.3,37,29,3,26,21,100,29,1,2295.0
Gabriel Veiga,6,2,20,25.5,43,19,14,25,4,16,52,30.8,36,30,3,27,21,64,6,0,2295.0
Ismaël Doukouré,2,3,19,25.5,48,24,23,21,4,20,34,58.8,14,26,8,18,27,75,54,0,2295.0
Sergio Akieme,0,2,24,25.5,27,16,19,6,2,12,22,54.5,10,22,6,16,14,41,41,0,2295.0
Maxime Lopez,6,4,24,25.5,42,18,26,12,4,16,56,28.6,40,24,6,18,22,64,21,0,2295.0
Ben Davies,0,1,29,25.4,28,11,13,13,2,14,26,53.8,12,17,8,9,18,46,72,0,2286.0
Manuel Akanji,0,1,27,25.4,36,25,15,18,3,23,36,63.9,13,27,9,18,16,52,33,0,2286.0
Konstantinos Mavropanos,0,0,24,25.4,50,27,32,15,3,28,38,73.7,10,39,18,21,63,113,99,0,2286.0
Piotr Zieliński,6,4,28,25.4,17,10,1,11,5,12,25,48.0,13,16,5,11,14,31,7,0,2286.0
Wilfried Zaha,5,1,29,25.4,32,20,12,12,8,8,21,38.1,13,21,1,20,16,48,9,0,2286.0
Raphaël Guerreiro,2,0,28,25.4,36,20,13,15,8,21,34,61.8,13,21,2,19,36,72,23,0,2286.0
David Okereke,5,4,24,25.2,12,8,4,5,3,3,16,18.8,13,23,3,20,10,22,12,0,2268.0
Filippo Bandinelli,6,4,27,25.2,55,34,19,26,10,17,45,37.8,28,20,7,13,18,73,40,0,2268.0
Daichi Kamada,6,0,25,25.2,51,31,10,37,4,31,57,54.4,26,31,2,29,16,67,17,1,2268.0
Tonny Vilhena,6,4,27,25.2,44,22,16,23,5,20,50,40.0,30,17,7,10,18,62,21,0,2268.0
Miloš Veljković,0,0,26,25.2,30,19,17,13,0,18,29,62.1,11,32,16,16,33,63,103,0,2268.0
Mikkel Desler,0,3,27,25.1,71,38,36,27,8,43,67,64.2,24,35,6,29,36,107,48,2,2259.0
Axel Witsel,2,2,33,25.1,36,22,22,11,3,17,31,54.8,14,20,11,9,23,59,76,0,2259.0
Joel Ward,0,1,32,25.1,50,36,30,11,9,30,41,73.2,11,32,16,16,25,75,80,1,2259.0
Gideon Mensah,0,3,24,25.1,80,44,43,32,5,44,77,57.1,33,33,10,23,38,118,41,0,2259.0
Domagoj Bradarić,0,4,22,25.0,26,19,14,8,4,7,16,43.8,9,20,5,15,21,47,44,0,2250.0
Nico Schlotterbeck,0,0,22,25.0,59,34,34,24,1,37,53,69.8,16,38,21,17,32,91,71,1,2250.0
Diogo Leite,0,0,23,25.0,35,20,21,14,0,21,34,61.8,13,23,14,9,26,61,99,1,2250.0
Darko Lazović,2,4,31,24.9,24,13,9,12,3,13,29,44.8,16,14,3,11,16,40,19,0,2241.0
Linton Maina,5,0,23,24.9,18,12,5,11,2,7,30,23.3,23,19,0,19,5,23,9,0,2241.0
Jonjoe Kenny,0,0,25,24.9,46,34,27,16,3,24,42,57.1,18,38,9,29,46,92,74,0,2241.0
Jim Allevinah,1,3,27,24.9,39,24,24,11,4,19,62,30.6,43,24,2,22,24,63,26,1,2241.0
Adrien Hunou,8,3,28,24.8,39,20,17,16,6,16,45,35.6,29,35,0,35,7,46,7,0,2232.0
Thilo Kehrer,0,1,25,24.8,43,24,25,14,4,21,44,47.7,23,16,6,10,34,77,76,1,2232.0
Aaron Cresswell,0,1,32,24.8,21,11,12,7,2,12,31,38.7,19,21,11,10,27,48,56,0,2232.0
Grejohn Kyei,3,3,26,24.8,16,7,2,9,5,4,13,30.8,9,14,3,11,6,22,22,0,2232.0
Joe Worrall,0,1,25,24.7,53,25,39,12,2,25,35,71.4,10,33,23,10,26,79,111,1,2223.0
Christoph Kramer,6,0,31,24.7,44,33,24,15,5,22,55,40.0,33,34,2,32,17,61,40,0,2223.0
Maximiliano Caufriez,0,3,25,24.7,40,24,31,8,1,20,28,71.4,8,33,18,15,34,74,70,0,2223.0
Roméo Lavia,6,1,18,24.7,60,35,27,29,4,21,53,39.6,32,47,11,36,33,93,23,1,2223.0
Gian Marco Ferrari,0,4,30,24.7,23,16,11,10,2,10,17,58.8,7,29,20,9,23,46,81,4,2223.0
Ciro Immobile,3,4,32,24.7,11,5,4,4,3,6,9,66.7,3,10,2,8,1,12,14,0,2223.0
Éderson,6,4,23,24.6,67,34,18,42,7,29,66,43.9,37,56,7,49,36,103,31,0,2214.0
Nicolas Pallois,0,3,34,24.6,69,44,51,16,2,42,70,60.0,28,35,18,17,30,99,131,2,2214.0
Denzel Dumfries,0,4,26,24.6,35,18,17,13,5,22,34,64.7,12,33,9,24,12,47,26,0,2214.0
Vanderson,2,3,21,24.6,84,48,36,34,14,44,75,58.7,31,36,9,27,48,132,36,1,2214.0
Joakim Mæhle,2,4,25,24.6,32,18,12,7,13,22,39,56.4,17,29,6,23,24,56,26,0,2214.0
Renan Lodi,0,1,24,24.6,52,39,38,8,6,33,66,50.0,33,25,6,19,33,85,74,0,2214.0
Danilho Doekhi,0,0,24,24.6,38,23,21,17,0,14,26,53.8,12,27,12,15,29,67,93,0,2214.0
Sead Kolašinac,0,3,29,24.6,52,36,24,22,6,24,37,64.9,13,19,2,17,43,95,35,1,2214.0
Vitaly Janelt,7,1,24,24.5,54,27,20,24,10,21,49,42.9,28,29,9,20,29,83,26,0,2205.0
Copete,0,2,22,24.5,53,28,35,16,2,26,36,72.2,10,38,17,21,44,97,111,2,2205.0
Bernardo Silva,8,1,27,24.5,44,23,11,25,8,18,44,40.9,26,23,6,17,16,60,6,0,2205.0
Joe Scally,0,0,19,24.5,31,20,25,5,1,24,31,77.4,7,17,6,11,8,39,61,0,2205.0
Marco Verratti,6,3,29,24.4,76,49,34,36,6,38,89,42.7,51,42,6,36,27,103,11,3,2196.0
Jamal Musiala,8,0,19,24.4,34,23,9,16,9,13,35,37.1,22,30,3,27,19,53,3,0,2196.0
Isaac Carcelen,0,2,29,24.4,69,51,41,22,6,41,63,65.1,22,35,11,24,19,88,80,1,2196.0
Flavius Daniliuc,0,4,21,24.4,57,29,37,17,3,26,47,55.3,21,30,13,17,29,86,76,0,2196.0
Joan Gonzàlez,6,4,20,24.4,48,28,20,18,10,17,51,33.3,34,37,8,29,16,64,28,0,2196.0
Nicola Zalewski,0,4,20,24.4,45,26,25,15,5,22,71,31.0,49,27,1,26,31,76,23,0,2196.0
Pascal Struijk,0,1,22,24.4,84,57,43,31,10,49,75,65.3,26,32,12,20,32,116,70,1,2196.0
Chris Mepham,0,1,24,24.4,45,22,37,8,0,19,30,63.3,11,40,27,13,30,75,152,0,2196.0
Mohamed Camara,6,3,22,24.4,83,45,38,39,6,48,92,52.2,44,45,6,39,27,110,14,1,2196.0
Deiver Machado,2,3,28,24.3,45,26,18,20,7,21,34,61.8,13,21,4,17,21,66,27,0,2187.0
Benjamin Henrichs,2,0,25,24.3,73,46,41,29,3,43,66,65.2,23,48,4,44,35,108,46,0,2187.0
Joël Veltman,0,1,30,24.3,62,32,44,14,4,37,57,64.9,20,27,8,19,19,81,51,0,2187.0
Tammy Abraham,3,4,24,24.3,17,10,4,8,5,3,16,18.8,13,10,4,6,3,20,14,0,2187.0
Janik Haberer,6,0,28,24.3,29,17,8,18,3,17,48,35.4,31,35,2,33,14,43,25,0,2187.0
Ismael Diallo,0,3,25,24.2,46,33,35,9,2,35,63,55.6,28,26,12,14,30,76,46,1,2178.0
Rodrigo Riquelme,8,2,22,24.2,20,8,8,8,4,9,35,25.7,26,16,0,16,11,31,5,0,2178.0
Erhan Mašović,2,0,23,24.2,50,31,28,21,1,30,51,58.8,21,30,14,16,27,77,79,0,2178.0
Armand Lauriente,3,4,23,24.2,21,15,5,7,9,8,21,38.1,13,20,0,20,12,33,8,0,2178.0
Lucas Martínez Quarta,0,4,26,24.1,80,48,44,32,4,42,61,68.9,19,41,19,22,48,128,78,1,2169.0
Arkadiusz Reca,0,4,27,24.1,44,28,22,12,10,19,32,59.4,13,21,5,16,24,68,54,0,2169.0
Filip Đuričić,8,4,30,24.1,43,22,18,20,5,14,32,43.8,18,19,6,13,7,50,8,0,2169.0
Fabio Depaoli,0,4,25,24.1,48,28,25,16,7,25,44,56.8,19,32,6,26,18,66,33,3,2169.0
Mohamed Elyounoussi,8,1,27,24.1,46,28,22,20,4,19,43,44.2,24,40,3,37,27,73,37,0,2169.0
Andrea Cambiaso,0,4,22,24.1,57,34,34,20,3,28,65,43.1,37,26,2,24,26,83,33,1,2169.0
Joško Gvardiol,0,0,20,24.1,23,17,15,8,0,9,22,40.9,13,34,17,17,34,57,76,1,2169.0
Joaquín Fernández,0,2,26,24.0,35,28,20,11,4,19,30,63.3,11,31,22,9,27,62,98,1,2160.0
Tyler Adams,6,1,23,24.0,89,46,44,35,10,50,77,64.9,27,48,8,40,35,124,29,0,2160.0
Elba Rashani,8,3,29,24.0,39,26,13,19,7,13,39,33.3,26,27,2,25,21,60,19,0,2160.0
Remo Freuler,6,1,30,24.0,43,23,23,15,5,19,43,44.2,24,36,9,27,29,72,45,0,2160.0
Guillermo Maripán,0,3,28,24.0,46,26,26,20,0,17,33,51.5,16,39,27,12,38,84,87,0,2160.0
Hugo Mallo,0,2,31,24.0,53,29,34,14,5,28,42,66.7,14,28,7,21,24,77,73,0,2160.0
Alessandro Bastoni,0,4,23,24.0,41,20,20,14,7,11,27,40.7,16,27,13,14,24,65,45,0,2160.0
Andrea Pinamonti,3,4,23,24.0,10,7,0,5,5,3,7,42.9,4,19,2,17,2,12,11,0,2160.0
Michael Gregoritsch,3,0,28,23.9,19,12,6,9,4,3,21,14.3,18,23,4,19,5,24,10,0,2151.0
Diogo Dalot,0,1,23,23.9,54,41,40,13,1,33,45,73.3,12,25,7,18,37,91,55,2,2151.0
Toni Kroos,6,2,32,23.9,51,32,16,33,2,23,69,33.3,46,23,4,19,24,75,11,0,2151.0
Lucas Paquetá,6,1,24,23.9,71,53,23,36,12,27,66,40.9,39,41,4,37,16,87,31,0,2151.0
Thierno Balde,2,3,20,23.9,27,14,19,4,4,18,30,60.0,12,15,3,12,23,50,39,0,2151.0
Óscar Trejo,8,2,34,23.8,48,32,12,23,13,9,44,20.5,35,31,3,28,8,56,8,1,2142.0
Olivier Giroud,3,4,35,23.8,8,5,2,4,2,2,10,20.0,8,11,3,8,3,11,23,0,2142.0
Leandro Barreiro Martins,6,0,22,23.8,60,38,19,28,13,22,49,44.9,27,38,13,25,41,101,39,1,2142.0
Carles Pérez,8,2,24,23.8,39,23,12,17,10,22,66,33.3,44,29,3,26,6,45,9,0,2142.0
Iglesias,2,2,24,23.8,61,35,40,18,3,33,63,52.4,30,40,5,35,21,82,91,1,2142.0
Krzysztof Piątek,3,4,27,23.8,18,11,3,9,6,5,21,23.8,16,17,4,13,2,20,39,0,2142.0
Vladimír Coufal,0,1,29,23.7,58,31,37,15,6,36,51,70.6,15,24,6,18,38,96,70,0,2133.0
Kevin Agudelo,8,4,23,23.7,71,38,22,30,19,25,59,42.4,34,39,5,34,10,81,6,0,2133.0
Matteo Bianchetti,0,4,29,23.7,32,19,21,9,2,20,32,62.5,12,31,17,14,20,52,111,0,2133.0
Nikola Milenković,0,4,24,23.7,40,25,20,17,3,18,27,66.7,9,27,14,13,22,62,72,0,2133.0
Óliver Torres,8,2,27,23.7,39,23,12,13,14,18,59,30.5,41,26,5,21,10,49,10,0,2133.0
Himad Abdelli,8,3,22,23.7,64,38,22,32,10,31,67,46.3,36,30,1,29,28,92,15,0,2133.0
Riccardo Orsolini,3,4,25,23.6,30,19,15,10,5,17,41,41.5,24,29,3,26,8,38,18,0,2124.0
Casemiro,6,1,30,23.6,89,46,43,35,11,48,92,52.2,44,49,11,38,34,123,64,0,2124.0
Beto,3,4,24,23.6,16,9,0,9,7,4,17,23.5,13,18,3,15,6,22,30,0,2124.0
Willian,3,1,33,23.6,13,8,8,3,2,7,25,28.0,18,13,0,13,9,22,9,0,2124.0
Manuel Sánchez,0,2,21,23.6,51,35,35,9,7,33,63,52.4,30,33,5,28,14,65,51,0,2124.0
Carles Aleñá,8,2,24,23.5,18,10,7,5,6,5,34,14.7,29,19,1,18,4,22,18,0,2115.0
Niklas Süle,0,0,26,23.5,25,19,18,3,4,14,23,60.9,9,28,19,9,17,42,53,0,2115.0
Samuel Umtiti,0,4,28,23.5,52,34,25,25,2,18,26,69.2,8,26,14,12,26,78,79,0,2115.0
Wissam Ben Yedder,3,3,31,23.5,16,9,2,5,9,4,13,30.8,9,15,0,15,4,20,0,0,2115.0
Lisandro Martínez,0,1,24,23.5,54,28,33,18,3,30,43,69.8,13,51,27,24,33,87,103,0,2115.0
Raúl Albiol,0,2,36,23.5,25,17,17,6,2,14,18,77.8,4,17,13,4,14,39,111,0,2115.0
Aurélien Tchouaméni,6,2,22,23.5,64,40,23,36,5,23,38,60.5,15,20,6,14,49,113,50,0,2115.0
Oleksandr Zinchenko,0,1,25,23.5,40,18,14,17,9,21,39,53.8,18,20,2,18,22,62,38,2,2115.0
Mario Hermoso,0,2,27,23.4,22,15,14,6,2,9,30,30.0,21,19,9,10,19,41,85,1,2106.0
Yunus Musah,6,2,19,23.4,48,35,17,23,8,20,30,66.7,10,20,1,19,11,59,16,2,2106.0
Mattéo Guendouzi,6,3,23,23.4,39,18,9,21,9,14,38,36.8,24,12,5,7,21,60,18,0,2106.0
Ivan Perišić,2,1,33,23.4,42,24,25,10,7,27,47,57.4,20,29,7,22,22,64,49,1,2106.0
Kévin Gameiro,3,3,35,23.3,20,10,6,10,4,8,28,28.6,20,10,1,9,9,29,0,0,2097.0
Dani Rodríguez,6,2,34,23.3,42,23,18,22,2,21,46,45.7,25,31,8,23,21,63,14,0,2097.0
Conor Coady,0,1,29,23.3,14,9,8,6,0,7,15,46.7,8,21,17,4,14,28,88,3,2097.0
Ardian Ismajli,0,4,25,23.3,40,32,25,15,0,18,24,75.0,6,47,31,16,27,67,120,0,2097.0
Aleksei Miranchuk,6,4,26,23.2,11,5,3,4,4,3,11,27.3,8,11,0,11,2,13,5,0,2088.0
Bruno Amione,0,4,20,23.2,50,33,36,14,0,19,43,44.2,24,26,11,15,25,75,62,1,2088.0
Tosin Adarabioyo,0,1,24,23.2,30,13,22,6,2,16,23,69.6,7,20,15,5,26,56,140,1,2088.0
Niklas Stark,0,0,27,23.1,56,36,29,24,3,27,42,64.3,15,24,13,11,37,93,110,0,2079.0
Juan Cuadrado,1,4,34,23.1,50,34,34,13,3,27,65,41.5,38,15,2,13,24,74,32,0,2079.0
Krépin Diatta,8,3,23,23.0,30,21,4,17,9,13,32,40.6,19,29,1,28,17,47,12,0,2070.0
Anton Stach,6,0,23,23.0,27,21,10,15,2,16,38,42.1,22,28,2,26,41,68,25,0,2070.0
Jérémy Le Douaron,8,3,24,23.0,15,9,5,9,1,3,27,11.1,24,29,2,27,11,26,30,0,2070.0
Raphinha,3,2,25,23.0,29,19,10,7,12,11,31,35.5,20,33,1,32,14,43,11,1,2070.0
Saïd Benrahma,5,1,26,23.0,25,15,11,7,7,11,27,40.7,16,23,1,22,9,34,13,0,2070.0
Dejan Kulusevski,8,1,22,23.0,38,15,23,7,8,16,44,36.4,28,19,0,19,13,51,7,0,2070.0
Tete Morente,7,2,25,23.0,33,21,18,13,2,15,36,41.7,21,23,3,20,25,58,28,0,2070.0
Federico Dimarco,0,4,24,23.0,31,25,6,18,7,9,19,47.4,10,15,4,11,18,49,20,0,2070.0
Samuele Ricci,6,4,20,23.0,32,21,17,10,5,18,23,78.3,5,20,5,15,17,49,29,1,2070.0
Jordan Henderson,6,1,32,23.0,32,23,10,18,4,15,36,41.7,21,21,3,18,21,53,16,1,2070.0
Juan Cruz Armada,0,2,30,22.9,24,14,17,4,3,13,23,56.5,10,21,8,13,13,37,58,0,2061.0
Igor,0,4,24,22.9,43,29,21,18,4,20,27,74.1,7,33,14,19,25,68,56,2,2061.0
Gabriel Jesus,3,1,25,22.9,33,25,16,8,9,15,31,48.4,16,27,3,24,11,44,15,1,2061.0
Thiago Mendes,7,3,30,22.9,48,27,24,21,3,30,40,75.0,10,28,8,20,47,95,51,4,2061.0
Jakub Kamiński,4,0,20,22.9,36,25,15,13,8,20,40,50.0,20,37,2,35,8,44,15,0,2061.0
Nemanja Maksimović,6,2,27,22.8,41,30,17,18,6,19,32,59.4,13,36,14,22,34,75,27,0,2052.0
Luke Ayling,0,1,30,22.8,66,37,42,15,9,42,85,49.4,43,34,11,23,26,92,52,2,2052.0
Christian Eriksen,6,1,30,22.8,22,18,10,7,5,10,32,31.3,22,23,9,14,11,33,20,1,2052.0
Jack Grealish,3,1,26,22.8,25,16,10,12,3,13,22,59.1,9,17,3,14,7,32,9,0,2052.0
Achraf Hakimi,2,3,23,22.8,54,34,19,20,15,31,59,52.5,28,34,2,32,16,70,19,0,2052.0
Wilfried Singo,0,4,21,22.8,27,17,14,10,3,12,19,63.2,7,15,2,13,12,39,33,1,2052.0
Rubén Alcaraz,6,2,31,22.7,43,31,24,18,1,19,54,35.2,35,23,8,15,19,62,37,0,2043.0
Paulo Otávio,0,0,27,22.7,72,46,46,17,9,44,66,66.7,22,42,6,36,30,102,70,1,2043.0
Omar Alderete,0,2,25,22.7,35,20,21,14,0,28,40,70.0,12,23,16,7,26,61,85,0,2043.0
Alphonso Davies,0,0,21,22.7,45,28,25,13,7,18,39,46.2,21,28,4,24,24,69,24,4,2043.0
Lloyd Kelly,0,1,23,22.7,33,18,23,9,1,13,19,68.4,6,26,15,11,26,59,101,1,2043.0
Monchu,6,2,22,22.6,50,29,20,21,9,19,46,41.3,27,28,11,17,18,68,22,1,2034.0000000000002
Corentin Tolisso,6,3,27,22.6,44,27,16,23,5,25,66,37.9,41,25,5,20,24,68,23,1,2034.0000000000002
Óscar Plano,5,2,31,22.6,40,25,9,17,14,12,37,32.4,25,26,2,24,29,69,23,0,2034.0000000000002
Karim Benzema,3,2,34,22.6,9,5,2,4,3,2,11,18.2,9,11,0,11,2,11,5,0,2034.0000000000002
Anthony Caci,0,0,25,22.6,58,33,32,20,6,28,42,66.7,14,28,4,24,54,112,40,0,2034.0000000000002
Ashley Young,0,1,37,22.6,50,27,34,15,1,37,49,75.5,12,25,11,14,21,71,65,0,2034.0000000000002
Federico Di Francesco,5,4,28,22.6,28,16,7,11,10,9,19,47.4,10,16,0,16,8,36,14,0,2034.0000000000002
Matteo Darmian,0,4,32,22.5,56,30,29,15,12,31,47,66.0,16,33,5,28,21,77,36,0,2025.0
Suat Serdar,6,0,25,22.5,51,23,14,30,7,20,41,48.8,21,48,12,36,29,80,24,0,2025.0
Pedro Chirivella,6,3,25,22.5,33,22,12,15,6,17,44,38.6,27,24,1,23,20,53,7,0,2025.0
Saîf-Eddine Khaoui,6,3,27,22.5,47,28,14,25,8,15,47,31.9,32,17,2,15,33,80,8,0,2025.0
Mats Hummels,0,0,33,22.4,62,34,38,22,2,32,55,58.2,23,30,16,14,33,95,100,1,2015.9999999999998
Aimar Oroz,8,2,20,22.4,26,14,8,10,8,8,30,26.7,22,24,1,23,24,50,6,0,2015.9999999999998
Issa Diop,0,1,25,22.4,28,19,18,9,1,17,32,53.1,15,24,17,7,35,63,86,0,2015.9999999999998
Clément Lenglet,0,1,27,22.4,38,23,18,15,5,16,34,47.1,18,26,11,15,18,56,68,2,2015.9999999999998
Eric Martel,6,0,20,22.4,66,41,29,30,7,30,60,50.0,30,29,9,20,33,99,49,0,2015.9999999999998
Robert Gumny,0,0,24,22.4,34,24,13,15,6,11,27,40.7,16,21,7,14,26,60,62,1,2015.9999999999998
Tiago Djaló,0,3,22,22.4,31,21,23,7,1,13,20,65.0,7,17,11,6,23,54,60,1,2015.9999999999998
Pedro Bigas,0,2,31,22.4,37,20,30,7,0,18,29,62.1,11,25,14,11,33,70,95,0,2015.9999999999998
Maxime Le Marchand,0,3,32,22.4,39,24,23,14,2,19,31,61.3,12,22,14,8,37,76,74,0,2015.9999999999998
Eduardo Camavinga,7,2,19,22.3,68,48,32,21,15,24,64,37.5,40,24,5,19,17,85,25,0,2007.0
Aleksandar Mitrović,3,1,27,22.3,14,7,8,4,2,5,12,41.7,7,22,5,17,3,17,20,1,2007.0
Thierry Correia,0,2,23,22.3,71,52,46,22,3,31,54,57.4,23,25,2,23,24,95,54,2,2007.0
Leroy Sané,8,0,26,22.3,38,30,11,19,8,18,36,50.0,18,11,1,10,3,41,1,2,2007.0
Nuno da Costa,5,3,31,22.3,45,23,14,23,8,11,46,23.9,35,21,1,20,20,65,15,0,2007.0
Ismaël Bennacer,6,4,24,22.3,59,33,26,31,2,30,51,58.8,21,25,7,18,26,85,16,1,2007.0
Cyrille Bayala,6,3,26,22.3,53,37,16,20,17,23,47,48.9,24,20,3,17,25,78,21,0,2007.0
Jonathan Ikone,3,4,24,22.3,16,8,5,6,5,5,14,35.7,9,18,1,17,4,20,3,0,2007.0
Elseid Hysaj,0,4,28,22.2,39,23,24,11,4,23,41,56.1,18,31,7,24,20,59,42,0,1998.0
Rúben Dias,0,1,25,22.2,21,13,10,10,1,11,18,61.1,7,21,13,8,18,39,56,1,1998.0
Sofyan Amrabat,6,4,25,22.2,39,24,15,17,7,16,29,55.2,13,23,5,18,21,60,18,2,1998.0
Che Adams,3,1,26,22.1,17,13,7,8,2,7,12,58.3,5,13,4,9,4,21,22,0,1989.0000000000002
Silas Katompa,5,0,23,22.1,25,17,5,14,6,6,20,30.0,14,17,2,15,8,33,1,0,1989.0000000000002
Adam Webster,0,1,27,22.1,22,12,10,9,3,11,19,57.9,8,30,19,11,19,41,55,4,1989.0000000000002
Samu Costa,6,2,21,22.1,61,31,35,20,6,29,61,47.5,32,29,7,22,37,98,64,4,1989.0000000000002
Kurt Zouma,0,1,27,22.1,9,4,4,5,0,5,8,62.5,3,17,14,3,30,39,120,1,1989.0000000000002
Henrikh Mkhitaryan,6,4,33,22.1,41,26,13,22,6,14,41,34.1,27,27,4,23,21,62,18,0,1989.0000000000002
Pedri,6,2,19,22.0,39,22,15,17,7,13,45,28.9,32,27,0,27,13,52,8,1,1980.0
Thomas Foket,0,3,27,22.0,35,22,18,11,6,17,46,37.0,29,21,7,14,33,68,29,2,1980.0
Ko Itakura,0,0,25,22.0,29,17,18,7,4,16,30,53.3,14,41,25,16,27,56,95,0,1980.0
Alexis Flips,5,3,22,22.0,51,30,18,17,16,27,64,42.2,37,35,5,30,24,75,12,0,1980.0
Jesús Navas,1,2,36,22.0,19,12,8,3,8,11,22,50.0,11,18,7,11,22,41,52,1,1980.0
Miha Blažič,0,3,29,22.0,8,6,8,0,0,7,15,46.7,8,25,19,6,22,30,80,1,1980.0
Christopher Antwi-Adjei,5,0,28,22.0,23,15,7,8,8,10,29,34.5,19,17,0,17,5,28,16,0,1980.0
Kiliann Sildillia,2,0,20,22.0,33,20,10,19,4,18,30,60.0,12,24,9,15,21,54,47,1,1980.0
Mohammed Salisu,0,1,23,21.9,51,29,33,16,2,24,34,70.6,10,56,25,31,31,82,122,1,1970.9999999999998
Muhammed Saracevic Cham,6,3,21,21.9,30,15,15,4,11,13,35,37.1,22,13,0,13,7,37,5,0,1970.9999999999998
Leon Bailey,5,1,24,21.9,14,6,6,7,1,5,20,25.0,15,13,0,13,6,20,12,0,1970.9999999999998
Juan Foyth,0,2,24,21.8,73,48,49,22,2,41,57,71.9,16,32,11,21,20,93,68,0,1962.0
Kyle Walker,0,1,32,21.8,13,9,8,5,0,4,24,16.7,20,12,2,10,18,31,22,0,1962.0
Arne Maier,6,0,23,21.8,31,22,17,11,3,10,18,55.6,8,21,0,21,15,46,22,0,1962.0
Atakan Karazor,6,0,25,21.8,49,30,18,25,6,24,47,51.1,23,39,11,28,31,80,44,0,1962.0
Musa Barrow,5,4,23,21.8,21,4,10,6,5,8,14,57.1,6,25,1,24,1,22,7,0,1962.0
Rasmus Nissen,0,1,25,21.8,62,35,35,21,6,42,76,55.3,34,32,14,18,35,97,61,0,1962.0
Borna Sosa,0,0,24,21.7,27,21,18,8,1,21,32,65.6,11,20,5,15,19,46,37,0,1953.0
Rolando Mandragora,6,4,25,21.7,42,24,12,22,8,23,52,44.2,29,25,3,22,16,58,21,0,1953.0
Pasquale Mazzocchi,0,4,27,21.7,32,18,21,5,6,17,37,45.9,20,10,2,8,10,42,37,2,1953.0
Sinaly Diomande,0,3,21,21.7,42,24,26,15,1,31,49,63.3,18,26,13,13,49,91,75,1,1953.0
Kevin Akpoguma,0,0,27,21.7,75,44,45,27,3,32,45,71.1,13,45,16,29,24,99,70,1,1953.0
Adrien Truffert,0,3,20,21.7,62,32,36,17,9,31,46,67.4,15,32,8,24,22,84,55,0,1953.0
Amos Pieper,0,0,24,21.7,46,28,25,19,2,24,40,60.0,16,23,11,12,30,76,94,1,1953.0
Dennis Geiger,6,0,24,21.7,45,25,15,28,2,22,35,62.9,13,27,3,24,24,69,18,2,1953.0
Étienne Capoue,6,2,34,21.7,21,12,6,13,2,10,18,55.6,8,12,5,7,19,40,20,1,1953.0
Mathieu Coutadeur,6,3,36,21.6,23,13,13,10,0,8,28,28.6,20,19,3,16,19,42,21,0,1944.0000000000002
Stefan de Vrij,0,4,30,21.6,28,18,19,9,0,8,14,57.1,6,18,10,8,40,68,80,0,1944.0000000000002
Alex Baena,8,2,21,21.6,30,17,9,15,6,15,45,33.3,30,15,3,12,7,37,16,0,1944.0000000000002
Serge Gnabry,5,0,27,21.6,35,23,11,14,10,17,43,39.5,26,24,1,23,11,46,5,1,1944.0000000000002
Damián Suárez,2,2,34,21.6,49,33,23,19,7,26,47,55.3,21,40,0,40,15,64,36,0,1944.0000000000002
Matheus Henrique,6,4,24,21.6,26,12,9,11,6,12,24,50.0,12,15,4,11,12,38,10,0,1944.0000000000002
Serge Aurier,0,1,29,21.6,64,41,41,18,5,23,33,69.7,10,34,11,23,29,93,75,0,1944.0000000000002
Lorenzo Pirola,0,4,20,21.6,33,29,18,14,1,19,27,70.4,8,50,35,15,30,63,85,1,1944.0000000000002
Stefan Savić,0,2,31,21.6,39,26,29,7,3,26,39,66.7,13,17,8,9,33,72,67,2,1944.0000000000002
Theo Bongonda,8,2,26,21.5,28,20,11,14,3,17,40,42.5,23,21,2,19,6,34,14,0,1935.0
David Silva,6,2,36,21.5,36,21,11,18,7,11,19,57.9,8,17,2,15,15,51,16,0,1935.0
Rodrigo,5,1,31,21.5,24,10,2,15,7,8,19,42.1,11,16,4,12,6,30,21,1,1935.0
Johann Lepenant,6,3,19,21.5,58,34,24,27,7,32,86,37.2,54,29,5,24,28,86,17,3,1935.0
Mostafa Mohamed,3,3,24,21.5,18,13,5,7,6,9,20,45.0,11,23,1,22,10,28,33,0,1935.0
Timo Werner,5,0,26,21.5,10,5,4,3,3,4,12,33.3,8,12,0,12,7,17,5,0,1935.0
Danilo Cataldi,6,4,27,21.4,25,16,7,15,3,14,40,35.0,26,23,9,14,24,49,33,0,1925.9999999999998
Rodrigo De Paul,6,2,28,21.4,35,21,11,18,6,18,35,51.4,17,20,3,17,8,43,7,0,1925.9999999999998
Sebastiaan Bornauw,0,0,23,21.4,29,17,17,10,2,16,22,72.7,6,27,12,15,31,60,83,1,1925.9999999999998
Faitout Maouassa,4,3,24,21.4,52,32,26,20,6,18,41,43.9,23,31,3,28,20,72,23,0,1925.9999999999998
Dušan Vlahović,3,4,22,21.4,11,6,0,7,4,4,10,40.0,6,10,3,7,3,14,8,1,1925.9999999999998
Brahim Díaz,8,4,22,21.4,32,15,5,22,5,5,15,33.3,10,11,0,11,7,39,6,0,1925.9999999999998
Tyronne Ebuehi,0,4,26,21.4,22,14,11,7,4,9,13,69.2,4,23,12,11,12,34,79,1,1925.9999999999998
Helibelton Palacios,0,2,29,21.3,38,20,21,15,2,19,26,73.1,7,26,12,14,20,58,55,0,1917.0
Riyad Mahrez,5,1,31,21.3,30,14,8,13,9,13,38,34.2,25,27,1,26,9,39,5,0,1917.0
Moussa Sissoko,6,3,32,21.3,26,16,16,7,3,12,18,66.7,6,22,5,17,16,42,17,0,1917.0
Dany Mota,5,4,24,21.3,8,7,1,3,4,2,10,20.0,8,5,1,4,6,14,25,0,1917.0
Aaron Hickey,0,1,20,21.3,38,26,27,11,0,18,32,56.3,14,18,7,11,17,55,32,1,1917.0
Raphaël Varane,0,1,29,21.2,24,9,18,6,0,7,17,41.2,10,24,17,7,11,35,91,0,1908.0
Marcos Acuña,0,2,30,21.2,57,36,34,17,6,30,42,71.4,12,16,5,11,23,80,36,0,1908.0
Giacomo Bonaventura,6,4,32,21.2,35,23,14,15,6,24,37,64.9,13,14,0,14,16,51,5,1,1908.0
Emre Can,6,0,28,21.1,57,28,25,27,5,22,43,51.2,21,16,6,10,25,82,39,1,1899.0000000000002
Clément Vidal,2,3,22,21.1,25,15,14,11,0,18,38,47.4,20,27,16,11,27,52,73,1,1899.0000000000002
Christopher Nkunku,5,0,24,21.1,6,4,2,1,3,1,6,16.7,5,8,3,5,8,14,11,0,1899.0000000000002
Álvaro Morata,3,2,29,21.1,16,11,4,8,4,3,8,37.5,5,11,3,8,0,16,23,0,1899.0000000000002
Pedro,3,4,35,21.1,35,24,14,10,11,11,30,36.7,19,18,2,16,6,41,4,1,1899.0000000000002
Lee Jae-sung,6,0,29,21.0,38,17,9,21,8,16,36,44.4,20,29,5,24,17,55,21,0,1890.0
Fabián Ruiz Peña,6,3,26,21.0,62,28,25,30,7,43,79,54.4,36,24,1,23,18,80,23,1,1890.0
Raheem Sterling,5,1,27,21.0,18,10,5,4,9,8,14,57.1,6,17,0,17,2,20,5,0,1890.0
Franco Cervi,7,2,28,21.0,76,46,29,36,11,33,66,50.0,33,33,1,32,36,112,16,0,1890.0
Álvaro Aguado,6,2,26,21.0,27,15,13,11,3,15,25,60.0,10,16,4,12,13,40,15,0,1890.0
Christian Groß,6,0,33,21.0,56,25,20,34,2,29,60,48.3,31,20,5,15,23,79,38,1,1890.0
Julian Weigl,6,0,26,21.0,43,16,21,21,1,23,41,56.1,18,23,2,21,18,61,32,0,1890.0
Karol Linetty,6,4,27,21.0,32,17,7,22,3,13,25,52.0,12,28,8,20,19,51,25,0,1890.0
Callum Wilson,3,1,30,20.9,9,3,0,8,1,0,3,0.0,3,8,0,8,1,10,5,0,1880.9999999999998
Armel Bella Kotchap,0,1,20,20.9,37,17,28,9,0,15,20,75.0,5,29,12,17,44,81,110,0,1880.9999999999998
Alejandro Pozo Pozo,0,2,23,20.9,37,19,17,17,3,27,53,50.9,26,30,5,25,26,63,45,1,1880.9999999999998
Manuel Lazzari,0,4,28,20.9,33,21,13,14,6,21,36,58.3,15,20,6,14,18,51,36,1,1880.9999999999998
Chris Führich,5,0,24,20.9,36,14,15,14,7,24,44,54.5,20,29,2,27,7,43,13,0,1880.9999999999998
Samuel Gigot,0,3,28,20.9,46,24,22,21,3,12,15,80.0,3,24,7,17,45,91,85,1,1880.9999999999998
Neco Williams,0,1,21,20.9,72,47,49,17,6,38,71,53.5,33,33,8,25,33,105,48,0,1880.9999999999998
Rayan Cherki,8,3,18,20.8,14,8,2,5,7,8,23,34.8,15,6,0,6,5,19,1,0,1872.0
Hicham Boudaoui,6,3,22,20.8,67,32,31,30,6,35,53,66.0,18,34,5,29,36,103,16,0,1872.0
Nathan Aké,0,1,27,20.8,26,12,15,9,2,11,15,73.3,4,20,10,10,20,46,48,0,1872.0
Gauthier Hein,8,3,25,20.8,27,20,13,11,3,18,48,37.5,30,10,0,10,6,33,10,0,1872.0
Yannick Gerhardt,6,0,28,20.7,29,15,10,11,8,12,30,40.0,18,26,5,21,7,36,24,0,1863.0
Domenico Berardi,3,4,27,20.7,23,14,8,10,5,9,40,22.5,31,13,0,13,19,42,18,0,1863.0
Henning Matriciani,0,0,22,20.7,43,23,28,12,3,26,60,43.3,34,28,11,17,23,66,57,1,1863.0
Adama Soumaoro,0,4,30,20.7,25,17,11,12,2,5,7,71.4,2,18,13,5,15,40,75,1,1863.0
Christian Kouamé,3,4,24,20.7,27,18,8,10,9,7,14,50.0,7,15,3,12,12,39,8,0,1863.0
Breel Embolo,3,3,25,20.7,15,9,2,7,6,5,10,50.0,5,14,3,11,5,20,12,0,1863.0
Luis Milla,6,2,27,20.6,48,30,21,18,9,19,44,43.2,25,13,1,12,32,80,25,1,1854.0000000000002
Rafael Ratão,5,3,26,20.6,52,36,29,16,7,27,73,37.0,46,34,0,34,21,73,7,0,1854.0000000000002
Gonzalo Melero,6,2,28,20.6,32,16,9,18,5,11,39,28.2,28,23,2,21,7,39,19,1,1854.0000000000002
Lazar Samardzic,6,4,20,20.6,33,16,9,20,4,17,43,39.5,26,13,0,13,11,44,16,0,1854.0000000000002
Danny Welbeck,3,1,31,20.6,15,7,0,7,8,4,11,36.4,7,24,2,22,5,20,20,0,1854.0000000000002
Nemanja Matić,6,4,33,20.6,47,27,24,19,4,19,33,57.6,14,27,7,20,25,72,21,1,1854.0000000000002
Jamie Vardy,3,1,35,20.6,10,5,4,3,3,1,7,14.3,6,17,3,14,2,12,30,0,1854.0000000000002
Reinildo Mandava,0,2,28,20.6,66,43,46,19,1,38,49,77.6,11,27,12,15,30,96,59,0,1854.0000000000002
Jens Stage,6,0,25,20.6,34,17,15,18,1,10,37,27.0,27,34,11,23,16,50,37,0,1854.0000000000002
Érik Lamela,5,2,30,20.5,46,27,14,16,16,12,34,35.3,22,26,2,24,7,53,3,0,1845.0
Pere Milla,5,2,29,20.5,31,20,18,8,5,14,41,34.1,27,18,3,15,9,40,19,1,1845.0
Fede San Emeterio,6,2,25,20.5,41,22,23,16,2,22,46,47.8,24,34,14,20,17,58,28,0,1845.0
John Stones,2,1,28,20.5,23,13,11,8,4,7,10,70.0,3,17,10,7,9,32,40,0,1845.0
Maximilian Bauer,0,0,22,20.5,31,17,18,12,1,17,34,50.0,17,25,9,16,23,54,79,1,1845.0
Aarón Martín,0,0,25,20.5,42,27,25,11,6,21,40,52.5,19,22,1,21,15,57,31,0,1845.0
Phil Foden,3,1,22,20.5,16,10,9,5,2,8,19,42.1,11,25,2,23,5,21,12,0,1845.0
Arnaud Kalimuendo,3,3,20,20.5,15,8,3,6,6,5,20,25.0,15,15,2,13,2,17,9,0,1845.0
Felix Nmecha,6,0,21,20.4,41,24,11,23,7,16,34,47.1,18,26,10,16,25,66,31,0,1835.9999999999998
Luka Lochoshvili,0,4,24,20.4,45,19,30,11,4,22,31,71.0,9,31,10,21,22,67,89,0,1835.9999999999998
Marco Richter,8,0,24,20.4,43,23,18,17,8,19,48,39.6,29,29,2,27,24,67,25,0,1835.9999999999998
Ryan Christie,8,1,27,20.4,34,22,10,23,1,14,49,28.6,35,16,4,12,26,60,20,0,1835.9999999999998
Mads Pedersen,2,0,25,20.4,44,23,31,11,2,22,33,66.7,11,32,9,23,20,64,41,1,1835.9999999999998
David Alaba,0,2,30,20.4,15,11,8,4,3,9,15,60.0,6,18,9,9,14,29,37,1,1835.9999999999998
Mattias Svanberg,8,0,23,20.4,25,16,8,16,1,10,30,33.3,20,27,5,22,21,46,25,1,1835.9999999999998
Romain Perraud,0,1,24,20.4,54,33,23,23,8,28,52,53.8,24,24,6,18,20,74,42,0,1835.9999999999998
Abdallah Sima,3,3,21,20.4,22,13,4,15,3,7,19,36.8,12,8,0,8,4,26,19,0,1835.9999999999998
Ryan Yates,6,1,24,20.4,38,19,19,16,3,14,22,63.6,8,26,8,18,10,48,44,0,1835.9999999999998
Rasmus Højlund,3,4,19,20.4,4,3,0,2,2,1,6,16.7,5,9,1,8,1,5,5,0,1835.9999999999998
Michail Antonio,3,1,32,20.3,14,7,1,8,5,3,12,25.0,9,13,5,8,5,19,9,0,1827.0
Simon Terodde,3,0,34,20.3,15,8,4,7,4,3,14,21.4,11,6,2,4,6,21,9,0,1827.0
Mahdi Camara,6,3,24,20.2,63,36,18,38,7,25,43,58.1,18,35,4,31,40,103,16,0,1818.0
Matty Cash,0,1,24,20.2,55,32,36,15,4,26,37,70.3,11,20,5,15,26,81,43,0,1818.0
Isaac Success,3,4,26,20.2,8,4,2,5,1,3,8,37.5,5,13,2,11,4,12,18,0,1818.0
Nathan Collins,0,1,21,20.2,27,15,19,8,0,15,24,62.5,9,35,28,7,21,48,84,0,1818.0
Brecht Dejaegere,6,3,31,20.1,40,23,10,20,10,15,51,29.4,36,25,5,20,14,54,11,0,1809.0000000000002
Luiz Henrique,3,2,21,20.1,48,34,27,15,6,20,44,45.5,24,22,0,22,14,62,17,0,1809.0000000000002
Baptiste Santamaria,6,3,27,20.1,41,22,13,23,5,21,41,51.2,20,21,5,16,21,62,23,0,1809.0000000000002
Christopher Trimmel,0,0,35,20.1,31,16,16,12,3,20,31,64.5,11,14,1,13,25,56,48,0,1809.0000000000002
Johan Vásquez,0,4,23,20.1,41,26,34,7,0,18,39,46.2,21,27,20,7,45,86,93,1,1809.0000000000002
Assan Ceesay,3,4,28,20.1,23,18,7,8,8,9,17,52.9,8,15,2,13,3,26,24,0,1809.0000000000002
Ronald Araújo,0,2,23,20.0,26,18,12,13,1,6,9,66.7,3,15,7,8,12,38,41,1,1800.0
Antony,3,1,22,20.0,22,9,9,9,4,8,28,28.6,20,18,0,18,11,33,6,0,1800.0
Kalidou Koulibaly,0,1,31,20.0,45,31,34,8,3,26,40,65.0,14,30,13,17,29,74,77,0,1800.0
Antonín Barák,6,4,27,20.0,21,9,5,7,9,6,16,37.5,10,16,2,14,3,24,13,0,1800.0
Ante Budimir,3,2,31,20.0,19,9,0,12,7,2,10,20.0,8,10,0,10,5,24,19,0,1800.0
Berat Djimsiti,0,4,29,20.0,34,19,21,13,0,17,25,68.0,8,17,7,10,36,70,74,1,1800.0
Julian Chabot,0,0,24,20.0,36,23,19,14,3,20,35,57.1,15,30,18,12,41,77,105,0,1800.0
Odsonne Édouard,3,1,24,20.0,25,13,7,12,6,7,13,53.8,6,17,5,12,3,28,22,0,1800.0
Yasser Larouci,2,3,21,20.0,23,13,13,8,2,15,24,62.5,9,15,1,14,26,49,46,0,1800.0
Aridane Hernández,0,2,33,19.9,21,15,17,4,0,12,25,48.0,13,34,21,13,28,49,96,1,1790.9999999999998
Souleyman Doumbia,1,3,25,19.9,45,31,31,13,1,17,31,54.8,14,20,3,17,27,72,27,1,1790.9999999999998
Quentin Merlin,0,3,20,19.9,31,19,19,8,4,18,38,47.4,20,27,4,23,24,55,30,0,1790.9999999999998
Alex Sandro,0,4,31,19.9,35,20,16,16,3,15,22,68.2,7,27,10,17,15,50,64,1,1790.9999999999998
Cédric Avinel,0,3,35,19.9,13,7,8,5,0,8,12,66.7,4,20,13,7,15,28,91,1,1790.9999999999998
Ivan Rakitić,6,2,34,19.9,37,26,10,18,9,19,40,47.5,21,21,1,20,27,64,20,0,1790.9999999999998
Dani Carvajal,0,2,30,19.8,32,18,15,12,5,18,35,51.4,17,24,6,18,15,47,49,0,1782.0
Ismaily,0,3,32,19.8,41,18,16,16,9,17,32,53.1,15,25,5,20,21,62,39,0,1782.0
João Moutinho,6,1,35,19.8,51,30,24,21,6,19,46,41.3,27,22,6,16,18,69,20,0,1782.0
Édgar González,0,2,25,19.7,28,19,18,7,3,14,27,51.9,13,12,9,3,21,49,120,0,1773.0
Portu,7,2,30,19.7,28,21,14,10,4,18,42,42.9,24,23,3,20,17,45,20,1,1773.0
Tommaso Baldanzi,6,4,19,19.7,25,12,9,13,3,7,32,21.9,25,21,1,20,2,27,5,0,1773.0
Óscar Rodríguez Arnaiz,6,2,24,19.7,32,25,12,15,5,13,28,46.4,15,16,2,14,24,56,15,0,1773.0
Mario Pašalić,8,4,27,19.7,22,10,6,14,2,6,23,26.1,17,22,4,18,21,43,13,0,1773.0
Marcelo Brozović,6,4,29,19.7,37,22,13,22,2,11,37,29.7,26,23,7,16,22,59,28,0,1773.0
Boubacar Kamara,6,1,22,19.7,58,25,25,23,10,27,56,48.2,29,38,12,26,19,77,24,2,1773.0
Kevin Vogt,0,0,30,19.7,15,10,10,5,0,9,22,40.9,13,18,11,7,26,41,67,0,1773.0
Alassane Pléa,3,0,29,19.7,16,8,5,7,4,8,26,30.8,18,23,3,20,12,28,14,0,1773.0
Daniel Podence,5,1,26,19.7,27,17,13,9,5,6,31,19.4,25,19,0,19,7,34,6,0,1773.0
Milan Škriniar,0,4,27,19.7,29,18,14,11,4,18,32,56.3,14,18,13,5,13,42,46,3,1773.0
Wilson Odobert,8,3,17,19.6,20,14,10,7,3,9,25,36.0,16,11,0,11,15,35,5,0,1764.0000000000002
Christian Nørgaard,6,1,28,19.6,52,30,21,29,2,18,48,37.5,30,32,9,23,34,86,41,2,1764.0000000000002
Lucas Perrin,0,3,23,19.6,44,27,28,14,2,25,49,51.0,24,13,5,8,36,80,53,0,1764.0000000000002
Julian Jeanvier,0,3,30,19.6,32,17,24,8,0,13,22,59.1,9,24,17,7,27,59,96,1,1764.0000000000002
Andreas Christensen,0,2,26,19.6,20,15,9,11,0,10,16,62.5,6,14,12,2,21,41,47,0,1764.0000000000002
Danilo Soares,0,0,30,19.6,72,46,42,23,7,43,72,59.7,29,29,6,23,30,102,56,1,1764.0000000000002
Luiz Felipe,0,2,25,19.6,34,23,23,11,0,18,34,52.9,16,43,24,19,28,62,106,0,1764.0000000000002
Pablo Rosario,7,3,25,19.6,46,26,22,20,4,18,34,52.9,16,15,5,10,23,69,32,1,1764.0000000000002
Thibault De Smet,0,3,24,19.5,24,17,10,14,0,11,37,29.7,26,28,5,23,20,44,40,1,1755.0
Aihen Muñoz,0,2,24,19.5,38,23,17,17,4,22,47,46.8,25,26,5,21,9,47,38,0,1755.0
Luka Modrić,6,2,36,19.4,19,9,6,6,7,10,25,40.0,15,15,5,10,10,29,7,0,1745.9999999999998
Mário Rui,0,4,31,19.4,34,22,17,13,4,20,41,48.8,21,17,4,13,15,49,24,1,1745.9999999999998
Timothy Weah,1,3,22,19.4,24,14,13,9,2,16,29,55.2,13,17,3,14,23,47,18,0,1745.9999999999998
Marcus Tavernier,8,1,23,19.4,33,22,19,11,3,11,32,34.4,21,25,4,21,9,42,23,0,1745.9999999999998
Iván Fresneda,0,2,17,19.4,48,34,31,13,4,29,47,61.7,18,32,8,24,15,63,60,0,1745.9999999999998
Nicolò Rovella,6,4,20,19.3,45,29,22,21,2,13,36,36.1,23,20,1,19,40,85,17,0,1737.0
Emerson,0,1,23,19.3,54,33,38,12,4,27,40,67.5,13,17,3,14,18,72,75,0,1737.0
André Silva,3,0,26,19.3,12,6,2,5,5,3,8,37.5,5,11,1,10,3,15,3,0,1737.0
Norbert Gyömbér,0,4,30,19.3,32,23,25,6,1,16,24,66.7,8,33,22,11,35,67,92,0,1737.0
Paulo Dybala,8,4,28,19.3,14,4,1,8,5,8,26,30.8,18,12,1,11,8,22,4,0,1737.0
Albin Ekdal,6,4,33,19.3,37,20,14,20,3,19,45,42.2,26,24,2,22,26,63,36,0,1737.0
Dimitri Foulquier,0,2,29,19.3,31,19,17,8,6,20,28,71.4,8,19,3,16,14,45,40,0,1737.0
Lars Stindl,5,0,33,19.3,24,14,4,17,3,10,28,35.7,18,24,5,19,11,35,19,0,1737.0
Edin Džeko,3,4,36,19.2,3,2,0,3,0,0,4,0.0,4,15,1,14,3,6,25,0,1728.0
Leon Goretzka,6,0,27,19.2,43,24,21,16,6,27,48,56.3,21,40,3,37,30,73,32,0,1728.0
Ademola Lookman,5,4,24,19.2,13,5,2,6,5,3,15,20.0,12,18,0,18,4,17,1,0,1728.0
Léo Baptistão,5,2,29,19.2,32,20,13,16,3,13,33,39.4,20,17,2,15,19,51,12,0,1728.0
Filip Uremović,0,0,25,19.2,38,23,29,8,1,14,22,63.6,8,18,13,5,36,74,88,2,1728.0
Lewis Cook,6,1,25,19.1,37,22,10,22,5,18,42,42.9,24,29,10,19,23,60,31,0,1719.0000000000002
Harry Winks,6,4,26,19.1,27,12,7,18,2,14,43,32.6,29,14,8,6,24,51,24,0,1719.0000000000002
Mërgim Vojvoda,0,4,27,19.1,22,12,15,6,1,12,24,50.0,12,14,2,12,10,32,31,1,1719.0000000000002
Ruan,0,4,23,19.0,38,26,25,12,1,19,29,65.5,10,29,17,12,24,62,80,3,1710.0
Francesco Caputo,3,4,34,19.0,2,2,0,1,1,0,1,0.0,1,7,2,5,2,4,8,0,1710.0
Takuma Asano,5,0,27,19.0,14,9,4,4,6,7,16,43.8,9,17,1,16,8,22,8,0,1710.0
Ezequiel Ávila,5,2,28,19.0,8,5,2,4,2,6,23,26.1,17,12,1,11,8,16,16,0,1710.0
Mateo Kovačić,6,1,28,19.0,36,24,16,14,6,14,36,38.9,22,10,1,9,19,55,16,0,1710.0
Dejan Ljubicic,8,0,24,19.0,25,14,7,14,4,13,40,32.5,27,20,1,19,8,33,8,1,1710.0
Andoni Gorosabel,0,2,25,19.0,41,25,23,9,9,26,43,60.5,17,21,2,19,17,58,23,0,1710.0
Fali,2,2,28,19.0,27,19,19,8,0,18,29,62.1,11,24,15,9,13,40,70,1,1710.0
Fidel,8,2,32,19.0,15,10,8,5,2,4,38,10.5,34,9,0,9,5,20,8,0,1710.0
Donyell Malen,3,0,23,19.0,13,5,3,4,6,5,12,41.7,7,14,1,13,4,17,11,0,1710.0
Unai García,0,2,30,19.0,23,13,13,8,2,12,17,70.6,5,23,14,9,19,42,60,2,1710.0
Martin Satriano,3,4,21,18.9,13,8,5,6,2,6,14,42.9,8,5,0,5,3,16,22,0,1700.9999999999998
Marcos Llorente,7,2,27,18.9,32,15,16,10,6,17,30,56.7,13,26,2,24,17,49,19,0,1700.9999999999998
Florent Ogier,0,3,33,18.9,33,16,20,12,1,22,39,56.4,17,22,13,9,18,51,64,1,1700.9999999999998
Jørgen Strand Larsen,3,2,22,18.9,15,7,3,5,7,7,30,23.3,23,14,5,9,3,18,24,0,1700.9999999999998
Iddrisu Baba,7,2,26,18.9,31,17,15,16,0,15,32,46.9,17,18,8,10,11,42,39,0,1700.9999999999998
Silvan Widmer,0,0,29,18.8,26,17,15,10,1,20,39,51.3,19,22,8,14,31,57,28,0,1692.0
Iker Muniain,8,2,29,18.8,21,16,7,11,3,6,17,35.3,11,10,1,9,4,25,2,0,1692.0
Darwin Núñez,3,1,23,18.8,11,5,2,4,5,4,17,23.5,13,10,0,10,3,14,13,0,1692.0
Hugo Magnetti,6,3,24,18.8,43,27,18,23,2,23,63,36.5,40,21,1,20,25,68,12,0,1692.0
Matías Vecino,6,4,30,18.8,47,27,13,23,11,23,48,47.9,25,33,10,23,16,63,39,1,1692.0
Riad Nouri,8,3,37,18.8,21,12,7,10,4,12,29,41.4,17,8,1,7,15,36,11,0,1692.0
Davide Calabria,0,4,25,18.8,71,44,31,32,8,38,61,62.3,23,22,7,15,25,96,34,0,1692.0
Fabien Centonze,0,3,26,18.8,58,37,30,22,6,30,42,71.4,12,24,7,17,44,102,55,1,1692.0
Jesper Lindstrøm,8,0,22,18.7,26,11,15,7,4,7,22,31.8,15,25,3,22,9,35,9,0,1683.0
Wilfred Ndidi,6,1,25,18.7,61,42,34,24,3,17,43,39.5,26,32,14,18,38,99,48,3,1683.0
David Raum,2,0,24,18.7,39,25,23,12,4,17,29,58.6,12,24,6,18,16,55,26,1,1683.0
Jadon Sancho,5,1,22,18.7,16,10,7,5,4,8,28,28.6,20,25,2,23,7,23,6,0,1683.0
Flavien Tait,6,3,29,18.7,30,15,8,17,5,19,42,45.2,23,16,4,12,20,50,12,0,1683.0
Stefan Mitrović,0,2,32,18.7,14,6,12,2,0,7,11,63.6,4,12,10,2,17,31,90,2,1683.0
Mergim Berisha,3,0,24,18.7,11,6,4,3,4,4,14,28.6,10,16,1,15,0,11,19,0,1683.0
Dylan Bronn,0,4,27,18.7,34,18,17,16,1,20,30,66.7,10,32,20,12,20,54,58,1,1683.0
Youssouf Sabaly,0,2,29,18.7,45,23,29,14,2,22,33,66.7,11,35,8,27,19,64,52,1,1683.0
César de la Hoz,6,2,30,18.6,37,20,17,18,2,19,37,51.4,18,26,6,20,13,50,37,0,1674.0000000000002
Eray Cömert,0,2,24,18.6,35,23,24,10,1,17,33,51.5,16,23,8,15,29,64,76,1,1674.0000000000002
Massadio Haïdara,2,3,29,18.6,24,16,9,9,6,12,24,50.0,12,26,9,17,36,60,39,1,1674.0000000000002
Marc Cucurella,0,1,24,18.6,66,33,40,15,11,30,60,50.0,30,28,8,20,16,82,48,1,1674.0000000000002
Jan Bednarek,0,1,26,18.6,27,21,20,7,0,12,16,75.0,4,38,27,11,49,76,87,0,1674.0000000000002
Romelu Lukaku,3,4,29,18.5,3,1,1,0,2,2,5,40.0,3,3,1,2,0,3,16,0,1665.0
Lovro Majer,8,3,24,18.5,34,23,16,13,5,8,29,27.6,21,21,1,20,21,55,5,1,1665.0
Youssef En-Nesyri,3,2,25,18.5,16,8,3,7,6,4,14,28.6,10,6,2,4,4,20,16,0,1665.0
Thomas Müller,5,0,32,18.5,21,12,5,9,7,6,16,37.5,10,19,3,16,4,25,16,0,1665.0
Andrea Petagna,3,4,27,18.5,7,5,2,3,2,3,6,50.0,3,16,4,12,3,10,18,0,1665.0
Pavel Kadeřábek,0,0,30,18.5,26,20,10,9,7,15,23,65.2,8,12,2,10,14,40,37,1,1665.0
Emanuel Aiwum,0,4,21,18.4,55,34,36,17,2,33,47,70.2,14,28,16,12,25,80,52,3,1655.9999999999998
Séamus Coleman,0,1,33,18.4,35,26,21,10,4,19,29,65.5,10,14,7,7,22,57,58,2,1655.9999999999998
David López,0,2,32,18.4,31,18,17,13,1,19,27,70.4,8,29,19,10,14,45,64,1,1655.9999999999998
Steve Mounié,3,3,27,18.4,13,5,1,7,5,5,14,35.7,9,18,7,11,3,16,20,0,1655.9999999999998
Enzo Roco,0,2,29,18.4,33,13,23,10,0,15,24,62.5,9,22,15,7,17,50,63,1,1655.9999999999998
Leonardo Spinazzola,0,4,29,18.4,15,8,7,6,2,8,23,34.8,15,13,3,10,9,24,25,0,1655.9999999999998
Julien Ponceau,6,3,21,18.4,28,19,10,14,4,10,32,31.3,22,27,3,24,14,42,12,0,1655.9999999999998
Hamza Sakhi,6,3,26,18.4,44,22,22,17,5,22,42,52.4,20,16,1,15,25,69,9,0,1655.9999999999998
Mitchel Bakker,2,0,22,18.4,16,8,9,7,0,6,15,40.0,9,20,2,18,15,31,20,2,1655.9999999999998
Rade Krunić,6,4,28,18.4,40,28,18,18,4,16,50,32.0,34,31,11,20,16,56,21,0,1655.9999999999998
Julien Laporte,0,3,28,18.4,22,16,18,3,1,16,22,72.7,6,33,27,6,18,40,108,2,1655.9999999999998
Exequiel Palacios,6,0,23,18.4,59,36,20,33,6,29,48,60.4,19,29,2,27,33,92,28,0,1655.9999999999998
Patrick Wimmer,5,0,21,18.3,39,26,18,11,10,12,38,31.6,26,27,2,25,15,54,15,0,1647.0
Sehrou Guirassy,3,0,26,18.3,4,1,2,2,0,1,2,50.0,1,7,2,5,0,4,14,0,1647.0
Mason Mount,8,1,23,18.3,33,19,6,16,11,14,27,51.9,13,24,6,18,8,41,9,0,1647.0
Juan Bernat,2,3,29,18.3,32,16,18,9,5,21,39,53.8,18,11,2,9,9,41,22,1,1647.0
Diego Rico,0,2,29,18.3,35,21,17,11,7,12,27,44.4,15,18,5,13,20,55,51,1,1647.0
Mathías Olivera,0,4,24,18.3,39,23,16,16,7,22,43,51.2,21,28,2,26,22,61,26,0,1647.0
Maxime Estève,0,3,20,18.3,24,13,17,5,2,12,17,70.6,5,28,17,11,34,58,90,0,1647.0
Lameck Banda,5,4,21,18.2,30,20,13,14,3,15,41,36.6,26,24,2,22,8,38,5,0,1638.0
Wahbi Khazri,5,3,31,18.2,26,13,13,7,6,6,25,24.0,19,17,1,16,9,35,20,0,1638.0
Nathaniel Clyne,0,1,31,18.2,27,16,13,9,5,14,23,60.9,9,22,4,18,19,46,34,0,1638.0
Nacho,0,2,32,18.2,24,16,17,5,2,12,29,41.4,17,11,6,5,18,42,37,0,1638.0
Lukas Kübler,0,0,29,18.2,37,25,24,9,4,18,30,60.0,12,25,11,14,29,66,50,0,1638.0
Mouhamadou Diarra,8,3,18,18.1,24,16,10,11,3,15,29,51.7,14,17,1,16,11,35,13,0,1629.0000000000002
André Gomes,6,3,29,18.1,37,19,12,17,8,19,52,36.5,33,20,5,15,9,46,16,1,1629.0000000000002
Paweł Dawidowicz,0,4,27,18.1,48,31,28,17,3,22,31,71.0,9,14,9,5,23,71,71,0,1629.0000000000002
Leonardo Bittencourt,7,0,28,18.1,53,28,20,25,8,25,62,40.3,37,13,0,13,10,63,15,0,1629.0000000000002
Boubakary Soumaré,6,1,23,18.1,57,34,29,26,2,23,43,53.5,20,15,4,11,33,90,27,1,1629.0000000000002
Alfonso Pedraza,0,2,26,18.1,35,26,20,10,5,19,29,65.5,10,19,1,18,18,53,31,0,1629.0000000000002
Elif Elmas,5,4,22,18.1,24,13,8,12,4,11,23,47.8,12,18,2,16,11,35,5,0,1629.0000000000002
Hugo Guillamón,6,2,22,18.1,20,12,10,8,2,8,24,33.3,16,14,2,12,19,39,30,2,1629.0000000000002
Maxence Lacroix,0,0,22,18.1,22,13,15,7,0,8,16,50.0,8,22,11,11,26,48,85,0,1629.0000000000002
Sanjin Prcić,6,3,28,18.1,27,12,6,16,5,19,31,61.3,12,22,7,15,25,52,22,0,1629.0000000000002
Andreas Bruus,1,3,23,18.1,12,6,9,3,0,8,20,40.0,12,13,2,11,17,29,24,0,1629.0000000000002
Conor Gallagher,6,1,22,18.0,46,33,17,19,10,10,37,27.0,27,41,10,31,23,69,18,1,1620.0
Stefano Sensi,6,4,26,18.0,41,26,25,13,3,18,48,37.5,30,13,3,10,20,61,4,0,1620.0
Jackson Porozo,0,3,21,18.0,32,20,24,7,1,13,31,41.9,18,24,17,7,33,65,75,0,1620.0
Roque Mesa,6,2,33,18.0,27,15,16,10,1,12,38,31.6,26,16,4,12,13,40,18,0,1620.0
Alexsandro Ribeiro,0,3,22,17.9,32,18,24,7,1,19,28,67.9,9,11,2,9,25,57,59,1,1610.9999999999998
Jawad El Yamiq,0,2,30,17.9,17,11,10,7,0,6,11,54.5,5,27,19,8,37,54,101,0,1610.9999999999998
Daniel Amartey,0,1,27,17.9,19,8,13,5,1,12,14,85.7,2,24,17,7,8,27,71,0,1610.9999999999998
Fernando Calero,2,2,26,17.9,46,29,27,15,4,21,34,61.8,13,31,13,18,13,59,52,0,1610.9999999999998
Trevoh Chalobah,0,1,23,17.9,31,20,22,6,3,24,34,70.6,10,17,7,10,24,55,56,1,1610.9999999999998
Harvey Elliott,8,1,19,17.9,27,18,6,12,9,9,36,25.0,27,26,1,25,15,42,8,0,1610.9999999999998
Yoane Wissa,3,1,25,17.8,17,12,4,7,6,6,13,46.2,7,10,0,10,6,23,15,0,1602.0
Akim Zedadka,0,3,27,17.8,35,21,21,10,4,18,32,56.3,14,17,3,14,23,58,51,1,1602.0
Hirving Lozano,3,4,27,17.8,24,13,10,6,8,9,21,42.9,12,31,0,31,15,39,6,0,1602.0
Iago,2,0,25,17.8,34,16,20,10,4,11,29,37.9,18,18,5,13,17,51,53,0,1602.0
Nicolas Jackson,3,2,21,17.8,14,11,2,10,2,2,8,25.0,6,18,2,16,2,16,4,0,1602.0
Nayef Aguerd,0,1,26,17.7,27,18,18,8,1,13,20,65.0,7,26,24,2,18,45,79,2,1593.0
Marlon,0,4,26,17.7,35,21,20,14,1,15,29,51.7,14,13,4,9,18,53,50,0,1593.0
Joan Jordán,6,2,28,17.7,32,17,13,17,2,16,38,42.1,22,14,7,7,16,48,14,2,1593.0
Steffen Tigges,3,0,24,17.7,12,7,1,8,3,4,14,28.6,10,13,2,11,8,20,17,0,1593.0
César Montes,0,2,25,17.7,17,9,10,7,0,10,18,55.6,8,19,12,7,14,31,101,0,1593.0
Malo Gusto,0,3,19,17.7,42,26,23,11,8,21,43,48.8,22,22,5,17,28,70,23,1,1593.0
Adil Rami,0,3,36,17.7,19,14,13,5,1,17,32,53.1,15,23,16,7,25,44,75,3,1593.0
Iván Martín,6,2,23,17.6,9,7,4,4,1,8,23,34.8,15,12,0,12,9,18,12,0,1584.0000000000002
Cyriel Dessers,3,4,27,17.6,11,4,4,4,3,2,6,33.3,4,14,2,12,3,14,5,0,1584.0000000000002
Ilia Gruev,6,0,22,17.6,44,27,16,25,3,18,31,58.1,13,23,6,17,22,66,21,1,1584.0000000000002
Souleymane Touré,0,3,19,17.6,29,13,19,9,1,16,20,80.0,4,32,12,20,26,55,56,1,1584.0000000000002
Arkadiusz Milik,3,4,28,17.6,12,8,2,8,2,2,8,25.0,6,10,1,9,1,13,14,0,1584.0000000000002
Aaron Ramsey,6,3,31,17.6,47,25,18,19,10,16,39,41.0,23,25,4,21,17,64,18,1,1584.0000000000002
Fernando,7,2,35,17.5,34,23,14,17,3,18,30,60.0,12,21,10,11,24,58,29,0,1575.0
Álex Fernández,8,2,29,17.5,13,7,6,4,3,4,14,28.6,10,14,1,13,8,21,19,0,1575.0
Salih Özcan,6,0,24,17.5,31,18,10,16,5,16,39,41.0,23,24,2,22,28,59,19,1,1575.0
Gerzino Nyamsi,0,3,25,17.5,28,20,14,12,2,10,12,83.3,2,19,11,8,10,38,63,1,1575.0
Scott McKenna,0,1,25,17.5,12,7,7,3,2,6,10,60.0,4,20,14,6,12,24,85,1,1575.0
Ibrahima Koné,3,3,23,17.5,24,13,3,13,8,5,11,45.5,6,13,0,13,4,28,18,0,1575.0
Kevin Lasagna,5,4,29,17.5,12,6,7,3,2,6,14,42.9,8,17,1,16,5,17,13,0,1575.0
Dani Ceballos,6,2,25,17.4,43,29,13,15,15,25,64,39.1,39,23,2,21,25,68,6,1,1565.9999999999998
Lassine Sinayoko,8,3,22,17.4,33,15,14,12,7,21,40,52.5,19,12,0,12,18,51,17,0,1565.9999999999998
Marius Wolf,0,0,27,17.4,25,18,9,12,4,16,29,55.2,13,40,10,30,18,43,22,1,1565.9999999999998
Marcel Halstenberg,0,0,30,17.3,40,21,20,15,5,23,41,56.1,18,22,1,21,21,61,29,0,1557.0
Kerem Demirbay,6,0,29,17.2,36,18,16,17,3,18,34,52.9,16,26,6,20,16,52,11,0,1548.0
Neymar,8,3,30,17.2,22,14,6,9,7,9,19,47.4,10,7,1,6,4,26,1,1,1548.0
Orel Mangala,6,1,24,17.2,28,20,16,10,2,12,29,41.4,17,21,7,14,23,51,15,0,1548.0
Nuno Mendes,0,3,20,17.2,45,30,29,12,4,30,41,73.2,11,19,3,16,17,62,18,0,1548.0
Ibrahima Konaté,0,1,23,17.2,38,26,25,13,0,16,27,59.3,11,12,5,7,26,64,61,4,1548.0
Dango Ouattara,5,3,20,17.2,41,26,20,11,10,15,28,53.6,13,24,6,18,19,60,21,0,1548.0
Enzo Fernández,6,1,21,17.2,45,27,25,17,3,21,56,37.5,35,32,2,30,16,61,12,1,1548.0
Alessandro Zanoli,0,4,21,17.1,22,14,14,6,2,8,17,47.1,9,19,15,4,12,34,39,0,1539.0000000000002
Dimitri Liénard,2,3,34,17.1,46,29,20,18,8,34,57,59.6,23,28,4,24,16,62,24,0,1539.0000000000002
Kingsley Ehizibue,0,4,27,17.1,47,31,28,13,6,29,45,64.4,16,21,3,18,10,57,42,1,1539.0000000000002
Ruben Loftus-Cheek,7,1,26,17.1,25,14,8,14,3,12,21,57.1,9,15,2,13,12,37,23,0,1539.0000000000002
Kevin Behrens,3,0,31,17.1,11,7,4,4,3,4,18,22.2,14,18,3,15,5,16,25,0,1539.0000000000002
Michel Aebischer,5,4,25,17.1,12,6,3,6,3,2,18,11.1,16,14,2,12,7,19,9,0,1539.0000000000002
Jens Cajuste,6,3,22,17.0,46,25,25,14,7,25,48,52.1,23,30,6,24,18,64,22,0,1530.0
César Azpilicueta,0,1,32,17.0,43,25,23,15,5,22,37,59.5,15,26,5,21,19,62,54,1,1530.0
Petar Stojanović,0,4,26,17.0,42,22,28,10,4,26,43,60.5,17,17,5,12,11,53,55,0,1530.0
Marko Arnautović,3,4,33,17.0,9,6,2,5,2,1,6,16.7,5,11,1,10,2,11,10,0,1530.0
Giangiacomo Magnani,0,4,26,17.0,33,22,20,11,2,19,25,76.0,6,20,15,5,21,54,76,0,1530.0
Luka Jović,5,4,24,17.0,6,3,1,4,1,2,8,25.0,6,7,2,5,2,8,10,0,1530.0
Merih Demiral,0,4,24,17.0,41,29,30,11,0,26,36,72.2,10,24,7,17,24,65,57,1,1530.0
Abdoulaye Doucouré,6,1,29,17.0,31,20,9,15,7,12,37,32.4,25,26,3,23,13,44,11,0,1530.0
Nicolò Fagioli,6,4,21,16.9,29,19,12,15,2,8,27,29.6,19,16,2,14,8,37,7,1,1520.9999999999998
Alexander Isak,3,1,22,16.9,18,8,4,7,7,10,28,35.7,18,21,2,19,4,22,8,0,1520.9999999999998
Ignatius Ganago,5,3,23,16.9,9,7,2,3,4,4,7,57.1,3,13,1,12,2,11,12,0,1520.9999999999998
Romano Schmid,8,0,22,16.9,24,15,5,13,6,10,22,45.5,12,21,3,18,7,31,12,0,1520.9999999999998
Gonzalo Montiel,0,2,25,16.9,26,15,12,14,0,15,29,51.7,14,25,7,18,19,45,38,0,1520.9999999999998
Stephan El Shaarawy,2,4,29,16.9,21,9,8,10,3,6,22,27.3,16,11,1,10,15,36,11,0,1520.9999999999998
Odilon Kossonou,0,0,21,16.9,21,14,12,7,2,8,16,50.0,8,26,11,15,24,45,58,1,1520.9999999999998
Patrick Bamford,3,1,28,16.8,9,6,0,6,3,4,20,20.0,16,12,5,7,5,14,13,0,1512.0
Lorenzo Colombo,3,4,20,16.8,17,9,1,9,7,6,14,42.9,8,22,0,22,2,19,7,0,1512.0
Rodrigo Bentancur,6,1,25,16.7,45,28,15,21,9,16,28,57.1,12,28,15,13,20,65,22,0,1503.0
Lucas Höler,5,0,28,16.7,19,14,5,7,7,6,22,27.3,16,22,5,17,10,29,17,0,1503.0
Pablo Fornals,5,1,26,16.7,30,15,9,12,9,13,34,38.2,21,16,2,14,14,44,9,0,1503.0
Zeki Çelik,0,4,25,16.7,42,21,19,21,2,24,41,58.5,17,33,6,27,14,56,36,2,1503.0
Gabriel Paulista,0,2,31,16.7,17,9,13,4,0,13,19,68.4,6,22,14,8,32,49,79,2,1503.0
Bamo Meïté,0,3,21,16.7,18,8,13,4,1,7,16,43.8,9,33,23,10,16,34,70,0,1503.0
Xaver Schlager,6,0,24,16.7,41,24,13,26,2,20,43,46.5,23,19,2,17,17,58,23,0,1503.0
Gastón Álvarez,0,2,22,16.7,38,30,24,9,5,23,42,54.8,19,15,5,10,15,53,35,0,1503.0
Lucas Digne,0,1,29,16.7,30,12,20,9,1,20,33,60.6,13,18,5,13,18,48,45,0,1503.0
Abdessamad Ezzalzouli,5,2,20,16.7,29,19,13,12,4,13,23,56.5,10,20,0,20,4,33,6,0,1503.0
Andreas Hanche-Olsen,0,0,25,16.6,35,23,24,7,4,22,39,56.4,17,16,8,8,33,68,77,2,1494.0000000000002
Lucas Olaza,0,2,28,16.6,24,14,12,10,2,17,26,65.4,9,20,8,12,14,38,34,0,1494.0000000000002
Nicolas Pépé,5,3,27,16.6,25,13,14,5,6,11,25,44.0,14,17,0,17,3,28,1,0,1494.0000000000002
Bram Nuytinck,0,4,32,16.6,54,38,33,21,0,23,34,67.6,11,36,21,15,23,77,84,0,1494.0000000000002
Adama Traoré,5,1,26,16.6,14,7,7,4,3,4,9,44.4,5,8,1,7,3,17,17,0,1494.0000000000002
Junior Messias,4,4,31,16.6,24,18,9,9,6,5,19,26.3,14,20,4,16,7,31,28,0,1494.0000000000002
Oliver Skipp,6,1,21,16.6,34,17,18,15,1,16,33,48.5,17,17,8,9,17,51,19,1,1494.0000000000002
Luis Javier Suárez,3,2,24,16.6,17,11,5,6,6,6,26,23.1,20,13,3,10,3,20,10,0,1494.0000000000002
Juan Brandáriz,0,2,23,16.5,29,16,18,9,2,14,23,60.9,9,20,7,13,15,44,53,0,1485.0
M'Baye Niang,3,3,27,16.5,13,7,1,8,4,3,13,23.1,10,22,1,21,1,14,20,0,1485.0
Davide Faraoni,0,4,30,16.5,34,24,19,13,2,16,41,39.0,25,30,11,19,15,49,37,0,1485.0
Luca de la Torre,6,2,24,16.5,28,19,11,14,3,12,32,37.5,20,22,1,21,9,37,6,0,1485.0
Dani García,6,2,32,16.5,46,27,17,25,4,29,47,61.7,18,21,6,15,19,65,21,1,1485.0
Emil Forsberg,8,0,30,16.5,16,11,1,8,7,6,20,30.0,14,25,2,23,3,19,7,0,1485.0
Viktor Tsyhankov,6,2,24,16.5,8,8,5,1,2,1,14,7.1,13,13,2,11,7,15,12,0,1485.0
Davide Zappacosta,0,4,30,16.4,34,18,17,12,5,15,22,68.2,7,23,2,21,9,43,16,0,1475.9999999999998
Cristian Gamboa,0,0,32,16.4,42,24,27,14,1,21,31,67.7,10,20,7,13,16,58,34,1,1475.9999999999998
Adri Embarba,5,2,30,16.4,50,27,21,26,3,22,46,47.8,24,23,0,23,9,59,9,0,1475.9999999999998
Josha Vagnoman,0,0,21,16.4,26,15,12,11,3,15,27,55.6,12,20,2,18,8,34,29,1,1475.9999999999998
Gary Medel,7,4,34,16.4,25,15,16,7,2,9,16,56.3,7,17,10,7,28,53,34,0,1475.9999999999998
Omar Marmoush,3,0,23,16.4,16,10,8,2,6,4,16,25.0,12,21,1,20,7,23,4,0,1475.9999999999998
Juan Miranda,0,2,22,16.4,23,16,16,6,1,14,29,48.3,15,20,7,13,20,43,63,0,1475.9999999999998
Cyle Larin,3,2,27,16.3,9,3,2,4,3,3,7,42.9,4,6,3,3,0,9,15,0,1467.0
Julián Álvarez,5,1,22,16.3,26,16,3,13,10,9,29,31.0,20,13,0,13,2,28,6,0,1467.0
Joe Gomez,0,1,25,16.3,28,21,15,11,2,11,19,57.9,8,17,11,6,24,52,51,2,1467.0
Konrad Laimer,6,0,25,16.3,60,31,23,30,7,30,54,55.6,24,31,4,27,18,78,8,0,1467.0
Simon Zoller,3,0,31,16.2,11,4,2,8,1,4,12,33.3,8,14,1,13,6,17,21,0,1458.0
Dejan Lovren,0,3,33,16.2,25,19,20,5,0,20,29,69.0,9,20,10,10,26,51,70,1,1458.0
Kristijan Jakić,2,0,25,16.2,33,21,19,12,2,22,41,53.7,19,32,10,22,14,47,49,1,1458.0
Nemanja Radonjić,8,4,26,16.2,2,1,2,0,0,0,4,0.0,4,3,0,3,2,4,4,0,1458.0
Grischa Prömel,6,0,27,16.2,27,19,14,11,2,9,25,36.0,16,22,4,18,8,35,23,0,1458.0
Ángel Correa,5,2,27,16.2,12,6,6,3,3,5,16,31.3,11,17,0,17,10,22,6,1,1458.0
Cody Gakpo,5,1,23,16.2,26,15,4,13,9,13,38,34.2,25,13,1,12,4,30,2,0,1458.0
Jordan Zemura,0,1,22,16.2,39,24,24,14,1,23,43,53.5,20,31,9,22,16,55,32,0,1458.0
Aïssa Mandi,0,2,30,16.2,18,10,14,3,1,6,12,50.0,6,19,14,5,21,39,58,0,1458.0
Frederic Guilbert,0,3,27,16.2,47,29,18,23,6,25,43,58.1,18,24,3,21,43,90,33,1,1458.0
Aitor Ruibal,1,2,26,16.2,47,29,35,9,3,31,58,53.4,27,17,2,15,24,71,41,0,1458.0
Mohamed Simakan,0,0,22,16.2,21,14,12,5,4,14,21,66.7,7,21,4,17,16,37,55,0,1458.0
Loïc Bade,0,2,22,16.1,27,20,23,3,1,17,30,56.7,13,21,13,8,23,50,77,0,1449.0000000000002
Edinson Cavani,3,2,35,16.1,7,4,3,3,1,3,15,20.0,12,10,3,7,2,9,11,0,1449.0000000000002
Federico Gatti,0,4,24,16.1,15,11,9,4,2,9,15,60.0,6,20,14,6,21,36,54,2,1449.0000000000002
Komnen Andrić,3,3,27,16.1,13,5,2,7,4,2,15,13.3,13,8,1,7,8,21,13,0,1449.0000000000002
Théo Le Bris,7,3,19,16.1,31,19,17,11,3,15,33,45.5,18,21,2,19,18,49,31,0,1449.0000000000002
Aritz Elustondo,0,2,28,16.1,26,17,15,10,1,14,26,53.8,12,15,6,9,20,46,43,1,1449.0000000000002
Maxime Gonalons,6,3,33,16.1,52,32,25,21,6,25,53,47.2,28,21,1,20,20,72,7,1,1449.0000000000002
Justin Kluivert,5,2,23,16.1,17,14,7,4,6,6,12,50.0,6,4,0,4,7,24,4,0,1449.0000000000002
Ohis Felix Uduokhai,0,0,24,16.1,30,20,14,13,3,15,29,51.7,14,27,14,13,29,59,61,1,1449.0000000000002
Renato Tapia,7,2,27,16.1,47,25,21,21,5,18,37,48.6,19,29,11,18,19,66,37,0,1449.0000000000002
Anthony Lozano,3,2,29,16.0,6,4,1,4,1,1,7,14.3,6,12,1,11,3,9,17,0,1440.0
Weston McKennie,6,1,23,16.0,30,13,5,18,7,10,29,34.5,19,22,3,19,22,52,26,0,1440.0
Arne Engels,6,0,18,16.0,20,9,9,10,1,8,19,42.1,11,17,5,12,15,35,12,1,1440.0
Marco Asensio,5,2,26,16.0,16,10,8,6,2,8,19,42.1,11,8,3,5,5,21,4,0,1440.0
Sergio Escudero,0,2,32,16.0,33,19,21,8,4,15,35,42.9,20,26,6,20,26,59,46,0,1440.0
Jakub Kiwior,0,4,22,16.0,22,17,15,7,0,6,24,25.0,18,26,18,8,24,46,71,1,1440.0
Bradley Barcola,5,3,19,16.0,25,16,8,10,7,8,39,20.5,31,29,0,29,19,44,10,0,1440.0
Arthur,3,4,24,15.9,9,2,1,4,4,4,8,50.0,4,10,1,9,1,10,12,0,1431.0
Amadou Haidara,6,0,24,15.9,25,11,15,10,0,13,34,38.2,21,26,6,20,26,51,20,0,1431.0
Amine Adli,5,0,22,15.9,18,10,4,6,8,5,17,29.4,12,28,2,26,6,24,7,0,1431.0
Alex Telles,0,2,29,15.9,21,13,15,6,0,13,25,52.0,12,17,5,12,20,41,38,0,1431.0
Pierrick Capelle,7,3,35,15.9,36,21,17,15,4,22,55,40.0,33,24,3,21,15,51,24,0,1431.0
Aaron Wan-Bissaka,0,1,24,15.9,40,25,20,17,3,23,25,92.0,2,24,8,16,22,62,41,0,1431.0
Gorka Guruzeta,3,2,25,15.8,24,20,6,12,6,11,24,45.8,13,23,2,21,4,28,8,0,1422.0
Liam Cooper,0,1,30,15.8,38,23,27,9,2,23,36,63.9,13,16,8,8,34,72,57,3,1422.0
Juanpe,0,2,31,15.8,19,11,10,9,0,11,17,64.7,6,12,9,3,10,29,60,1,1422.0
Felipe,0,1,33,15.8,42,23,29,13,0,24,41,58.5,17,34,13,21,36,78,90,0,1422.0
Romain Del Castillo,8,3,26,15.8,39,24,13,17,9,16,36,44.4,20,14,1,13,11,50,5,0,1422.0
Morgan Sanson,6,3,27,15.8,36,25,10,16,10,17,56,30.4,39,21,1,20,22,58,9,0,1422.0
Federico Ceccherini,0,4,30,15.8,25,19,15,9,1,13,23,56.5,10,17,10,7,19,44,55,0,1422.0
Jordi Alba,0,2,33,15.8,25,18,13,11,1,12,28,42.9,16,12,5,7,11,36,23,0,1422.0
Crysencio Summerville,3,1,20,15.8,30,20,14,14,2,11,23,47.8,12,20,2,18,13,43,11,0,1422.0
Agustín Rogel,0,0,24,15.8,18,9,13,5,0,11,17,64.7,6,15,8,7,11,29,74,1,1422.0
Sadio Mané,5,0,30,15.8,11,5,3,3,5,1,9,11.1,8,15,2,13,0,11,4,0,1422.0
Ihlas Bebou,4,0,28,15.7,19,16,8,7,4,11,17,64.7,6,9,2,7,7,26,15,0,1413.0
Michele Castagnetti,6,4,32,15.7,46,21,20,24,2,18,54,33.3,36,14,4,10,15,61,22,0,1413.0
Julian Ryerson,0,0,24,15.7,27,15,17,7,3,19,37,51.4,18,13,2,11,8,35,28,0,1413.0
Craig Dawson,0,1,32,15.7,9,6,6,3,0,4,7,57.1,3,31,23,8,12,21,74,2,1413.0
Ousmane Dembélé,3,2,25,15.7,19,12,4,8,7,4,15,26.7,11,10,1,9,0,19,2,0,1413.0
Patric,0,4,29,15.7,17,11,12,3,2,11,16,68.8,5,17,12,5,11,28,53,1,1413.0
Wilfried Kanga,3,0,24,15.7,5,4,2,1,2,2,4,50.0,2,14,3,11,2,7,13,0,1413.0
Kingsley Coman,5,0,26,15.7,11,8,3,5,3,7,17,41.2,10,19,1,18,2,13,7,0,1413.0
Kenny Lala,0,3,30,15.7,36,19,19,15,2,22,38,57.9,16,15,5,10,21,57,28,0,1413.0
Joe Rodon,0,3,24,15.7,11,7,9,2,0,4,10,40.0,6,16,12,4,9,20,54,1,1413.0
Sebastian Rode,6,0,31,15.7,38,24,7,28,3,14,45,31.1,31,18,2,16,16,54,12,0,1413.0
Eric García,2,2,21,15.7,24,16,16,5,3,9,20,45.0,11,23,10,13,19,43,36,1,1413.0
Taiwo Awoniyi,3,1,24,15.6,17,10,2,10,5,6,10,60.0,4,18,4,14,4,21,20,0,1404.0
Florian Neuhaus,6,0,25,15.6,19,9,9,5,5,8,27,29.6,19,20,3,17,12,31,5,0,1404.0
Largie Ramazani,5,2,21,15.6,15,9,6,3,6,8,27,29.6,19,11,0,11,15,30,10,0,1404.0
Stuart Armstrong,8,1,30,15.6,32,21,15,13,4,14,39,35.9,25,18,0,18,10,42,9,1,1404.0
David Pereira da Costa,8,3,21,15.6,13,7,1,10,2,7,19,36.8,12,19,1,18,11,24,6,0,1404.0
Nicolás González,6,2,20,15.6,27,15,11,13,3,9,25,36.0,16,21,7,14,19,46,16,0,1404.0
Ben Chilwell,2,1,25,15.6,21,17,12,8,1,13,25,52.0,12,21,2,19,18,39,26,0,1404.0
Alexis Saelemaekers,4,4,23,15.6,31,20,12,16,3,19,41,46.3,22,13,1,12,19,50,11,0,1404.0
Ainsley Maitland-Niles,2,1,24,15.6,45,24,23,18,4,28,44,63.6,16,28,7,21,22,67,45,1,1404.0
Samuele Birindelli,0,4,23,15.6,35,19,21,10,4,18,29,62.1,11,28,8,20,16,51,30,0,1404.0
Ferrán Torres,5,2,22,15.5,13,7,4,5,4,5,20,25.0,15,11,2,9,3,16,5,0,1395.0
Hans Hateboer,0,4,28,15.5,21,13,11,8,2,11,27,40.7,16,23,4,19,12,33,25,0,1395.0
Tyrell Malacia,0,1,22,15.5,46,33,33,12,1,14,25,56.0,11,13,3,10,25,71,49,0,1395.0
Gaëtan Perrin,8,3,26,15.5,17,8,5,6,6,8,30,26.7,22,15,0,15,10,27,9,0,1395.0
Duván Zapata,3,4,31,15.5,8,4,1,3,4,3,5,60.0,2,6,2,4,4,12,17,1,1395.0
Naouirou Ahamada,6,0,20,15.5,17,11,7,7,3,8,20,40.0,12,16,5,11,8,25,7,0,1395.0
Ansu Fati,3,2,19,15.5,16,9,8,4,4,5,19,26.3,14,19,0,19,5,21,6,0,1395.0
Emil Holm,0,4,22,15.5,26,15,13,8,5,16,31,51.6,15,21,6,15,9,35,41,0,1395.0
Omar Colley,0,4,29,15.4,17,10,10,7,0,9,12,75.0,3,9,5,4,22,39,69,1,1386.0
Ayoze Pérez,5,2,29,15.4,31,15,9,16,6,10,40,25.0,30,22,0,22,13,44,5,0,1386.0
Josh Dasilva,6,1,23,15.4,18,9,6,6,6,6,16,37.5,10,22,6,16,5,23,7,1,1386.0
Terem Moffi,3,3,23,15.4,8,5,1,4,3,3,5,60.0,2,11,3,8,3,11,10,0,1386.0
Hugo Duro,3,2,22,15.4,15,12,2,6,7,7,17,41.2,10,11,1,10,2,17,7,1,1386.0
Karim Adeyemi,5,0,20,15.4,16,11,6,6,4,8,30,26.7,22,18,1,17,7,23,3,0,1386.0
Valentino Lazaro,0,4,26,15.3,10,5,6,0,4,6,14,42.9,8,16,3,13,3,13,29,0,1377.0
Andrés Guardado,6,2,35,15.3,41,25,17,20,4,18,43,41.9,25,14,5,9,23,64,29,0,1377.0
Dion Lopy,6,3,20,15.3,45,24,22,16,7,23,62,37.1,39,27,3,24,22,67,18,0,1377.0
Kevin Kampl,6,0,31,15.2,21,11,6,14,1,6,27,22.2,21,26,9,17,22,43,11,0,1368.0
Milan Đurić,3,4,32,15.2,2,1,1,0,1,1,3,33.3,2,7,4,3,1,3,24,0,1368.0
Cenk Özkacar,0,2,21,15.2,27,20,17,10,0,14,19,73.7,5,14,2,12,12,39,47,4,1368.0
Tanguy Nianzou,0,2,20,15.2,20,15,10,9,1,8,11,72.7,3,8,5,3,16,36,44,3,1368.0
Abdoulaye Bamba,0,3,32,15.2,22,12,15,5,2,16,19,84.2,3,7,3,4,18,40,38,0,1368.0
Victor Lindelöf,0,1,28,15.2,22,17,10,9,3,9,17,52.9,8,18,9,9,21,43,63,1,1368.0
Issiaga Sylla,0,3,28,15.2,28,15,14,9,5,15,34,44.1,19,15,5,10,38,66,38,0,1368.0
Junior Firpo,0,1,25,15.2,47,25,27,15,5,24,46,52.2,22,23,7,16,24,71,40,0,1368.0
Dominick Drexler,8,0,32,15.2,25,17,12,10,3,9,22,40.9,13,18,2,16,8,33,12,0,1368.0
Mickaël Alphonse,0,3,33,15.1,35,23,20,11,4,20,33,60.6,13,17,5,12,35,70,44,1,1359.0
Jordan Pefok,3,0,26,15.1,15,7,3,4,8,2,17,11.8,15,17,5,12,4,19,15,0,1359.0
Jean-Daniel Akpa-Akpro,8,4,29,15.1,53,37,25,19,9,23,42,54.8,19,35,4,31,13,66,27,0,1359.0
Samu Castillejo,5,2,27,15.1,21,12,8,9,4,8,40,20.0,32,21,2,19,9,30,2,0,1359.0
Warmed Omari,0,3,22,15.1,20,11,14,6,0,14,28,50.0,14,13,7,6,17,37,43,1,1359.0
Malick Thiaw,0,4,20,15.1,31,26,22,9,0,11,20,55.0,9,11,5,6,12,43,65,1,1359.0
Ángel Di María,5,4,34,15.1,10,5,3,5,2,3,19,15.8,16,15,0,15,7,17,0,0,1359.0
Ferland Mendy,0,2,27,15.0,21,12,14,6,1,12,20,60.0,8,7,2,5,14,35,16,0,1350.0
Karl Toko Ekambi,5,3,29,15.0,9,9,2,4,3,4,15,26.7,11,12,2,10,9,18,6,0,1350.0
Marco Reus,8,0,33,15.0,30,17,12,14,4,7,24,29.2,17,12,4,8,8,38,8,0,1350.0
John Brooks,0,0,29,15.0,18,12,10,8,0,13,18,72.2,5,17,12,5,10,28,105,0,1350.0
Álex Moreno,0,2,29,15.0,29,22,19,10,0,18,36,50.0,18,17,4,13,17,46,39,0,1350.0
Josh Doig,0,4,20,15.0,19,8,6,7,6,6,16,37.5,10,25,6,19,11,30,13,1,1350.0
Degnand Gnonto,5,1,18,15.0,27,17,7,15,5,10,30,33.3,20,24,1,23,5,32,7,0,1350.0
Robert Skov,0,0,26,15.0,22,11,14,7,1,10,26,38.5,16,22,8,14,8,30,20,2,1350.0
Iñigo Martínez,0,2,31,14.9,18,8,11,7,0,6,9,66.7,3,17,11,6,18,36,55,0,1341.0
Thomas Mangani,6,3,35,14.8,32,17,14,15,3,18,47,38.3,29,22,3,19,24,56,22,1,1332.0
Sergio León,3,2,33,14.8,6,4,0,4,2,3,6,50.0,3,6,0,6,0,6,4,0,1332.0
Chimuanya Ugochukwu,6,3,18,14.8,36,19,13,20,3,16,24,66.7,8,24,10,14,21,57,16,0,1332.0
Adam Armstrong,5,1,25,14.8,14,9,6,5,3,3,10,30.0,7,15,3,12,5,19,6,0,1332.0
Renaud Ripart,5,3,29,14.7,40,23,14,20,6,19,52,36.5,33,29,2,27,7,47,5,0,1323.0
Rodrigo Zalazar,8,0,22,14.7,16,8,5,9,2,9,24,37.5,15,16,1,15,7,23,13,0,1323.0
Iñigo Lekue,0,2,29,14.7,24,17,20,4,0,12,19,63.2,7,16,2,14,13,37,31,1,1323.0
Remi Oudin,5,4,25,14.7,25,13,9,12,4,10,23,43.5,13,16,2,14,29,54,23,0,1323.0
Mickaël Barreto,6,3,31,14.7,32,20,12,17,3,8,45,17.8,37,17,0,17,18,50,11,0,1323.0
Sael Kumbedi,0,3,17,14.7,47,27,27,13,7,20,38,52.6,18,23,7,16,10,57,16,0,1323.0
Roberto Soriano,5,4,31,14.7,31,16,9,16,6,13,25,52.0,12,23,2,21,6,37,14,0,1323.0
Emerson Palmieri,0,1,27,14.7,26,14,9,15,2,12,24,50.0,12,17,4,13,15,41,36,0,1323.0
Martin Terrier,5,3,25,14.7,25,11,7,9,9,13,24,54.2,11,15,2,13,14,39,6,0,1323.0
Aurélio Buta,0,0,25,14.6,33,19,15,13,5,15,27,55.6,12,18,1,17,9,42,34,0,1314.0
Marcus Ingvartsen,5,0,26,14.6,4,1,0,2,2,1,10,10.0,9,9,1,8,4,8,10,0,1314.0
Ibrahima Sissoko,6,3,24,14.6,40,22,18,17,5,22,42,52.4,20,20,6,14,10,50,19,0,1314.0
Hugo Bueno,0,1,19,14.6,33,16,23,6,4,17,33,51.5,16,14,1,13,10,43,36,0,1314.0
Achraf Dari,0,3,23,14.6,21,14,15,5,1,14,20,70.0,6,16,10,6,19,40,65,2,1314.0
Iván Alejo,8,2,27,14.6,32,21,19,9,4,17,37,45.9,20,18,3,15,5,37,12,1,1314.0
Leandro Trossard,5,1,27,14.6,10,6,7,1,2,1,8,12.5,7,17,0,17,6,16,1,0,1314.0
Abdu Conté,0,3,24,14.6,25,17,14,8,3,12,22,54.5,10,13,6,7,6,31,25,0,1314.0
Kike Barja,5,2,25,14.6,15,9,6,5,4,8,24,33.3,16,7,0,7,4,19,3,0,1314.0
Noah Fadiga,0,3,22,14.5,30,21,18,9,3,14,26,53.8,12,17,7,10,26,56,18,0,1305.0
Sergi Roberto,2,2,30,14.5,22,15,12,6,4,7,18,38.9,11,15,7,8,11,33,16,0,1305.0
Philipp Förster,6,0,27,14.5,31,19,11,15,5,12,40,30.0,28,22,0,22,6,37,6,0,1305.0
Niko Gießelmann,0,0,30,14.5,21,11,9,9,3,13,31,41.9,18,17,5,12,9,30,28,0,1305.0
Makoto Hasebe,0,0,38,14.5,18,12,16,2,0,7,22,31.8,15,22,9,13,17,35,45,0,1305.0
Martin Hongla,2,2,24,14.5,18,13,13,5,0,11,21,52.4,10,15,12,3,8,26,46,1,1305.0
Mario Lemina,6,1,28,14.4,38,24,22,13,3,20,38,52.6,18,26,8,18,14,52,24,1,1296.0
Alberto Moreno,0,2,30,14.4,23,12,10,10,3,11,24,45.8,13,12,1,11,23,46,26,0,1296.0
Jean-Eudes Aholou,6,3,28,14.4,34,20,10,20,4,12,31,38.7,19,25,0,25,24,58,15,0,1296.0
Rafa Mir,3,2,25,14.4,8,2,2,4,2,2,5,40.0,3,5,1,4,4,12,11,0,1296.0
Stephy Mavididi,3,3,24,14.3,24,19,12,8,4,13,27,48.1,14,21,1,20,4,28,10,0,1287.0
Grigoris Kastanos,7,4,24,14.3,39,23,18,19,2,16,40,40.0,24,20,6,14,8,47,8,0,1287.0
Óscar Mingueza,0,2,23,14.3,37,21,27,9,1,25,32,78.1,7,10,4,6,12,49,25,0,1287.0
Mathias Autret,8,3,31,14.3,22,10,10,10,2,7,16,43.8,9,14,2,12,12,34,13,0,1287.0
Nicolò Cambiaghi,5,4,21,14.3,30,22,11,12,7,8,27,29.6,19,19,1,18,9,39,8,0,1287.0
Jeremy Doku,8,3,20,14.3,25,16,6,13,6,12,24,50.0,12,10,0,10,5,30,2,0,1287.0
Jonas Wind,3,0,23,14.3,14,6,2,7,5,5,10,50.0,5,14,4,10,1,15,10,0,1287.0
Stanley N'Soki,0,0,23,14.3,22,13,14,7,1,12,22,54.5,10,22,5,17,24,46,34,0,1287.0
Christopher Lenz,0,0,27,14.3,29,21,17,7,5,16,37,43.2,21,16,3,13,21,50,34,0,1287.0
Tiago Tomás,5,0,20,14.3,10,4,2,4,4,8,13,61.5,5,9,2,7,1,11,5,0,1287.0
Ansgar Knauff,0,0,20,14.3,36,25,22,11,3,15,34,44.1,19,19,1,18,15,51,26,0,1287.0
Adam Hložek,5,0,20,14.3,9,4,4,3,2,3,9,33.3,6,9,2,7,6,15,9,0,1287.0
Nathan Patterson,2,1,20,14.2,49,24,32,13,4,29,53,54.7,24,24,4,20,15,64,45,0,1278.0
João Cancelo,0,1,28,14.2,29,21,16,9,4,17,24,70.8,7,7,1,6,19,48,9,1,1278.0
Nicolas Cozza,0,3,23,14.2,38,21,27,9,2,26,38,68.4,12,11,5,6,21,59,35,1,1278.0
Adrien Thomasson,8,3,28,14.2,24,17,8,11,5,12,45,26.7,33,25,2,23,4,28,17,0,1278.0
Dani Olmo,8,0,24,14.2,15,9,1,10,4,6,14,42.9,8,15,0,15,6,21,6,0,1278.0
Kieffer Moore,3,1,29,14.2,14,11,2,9,3,5,16,31.3,11,12,5,7,1,15,26,0,1278.0
Pathé Ciss,7,2,28,14.2,39,29,11,23,5,15,34,44.1,19,23,10,13,22,61,34,0,1278.0
Jorginho,6,1,30,14.2,42,23,22,14,6,22,46,47.8,24,18,3,15,21,63,7,0,1278.0
Rubén Peña,2,2,31,14.2,32,18,10,18,4,20,41,48.8,21,23,8,15,17,49,31,0,1278.0
Dan-Axel Zagadou,0,0,23,14.1,14,9,10,4,0,5,14,35.7,9,19,16,3,21,35,81,1,1269.0
Maximilian Wöber,0,1,24,14.1,25,18,9,15,1,16,24,66.7,8,32,14,18,27,52,67,1,1269.0
Boubakar Kouyaté,0,3,25,14.0,31,18,18,11,2,19,35,54.3,16,24,14,10,34,65,73,1,1260.0
Jonny Castro,0,1,28,14.0,34,15,23,10,1,18,37,48.6,19,26,5,21,14,48,28,2,1260.0
Jaidon Anthony,8,1,22,14.0,30,17,15,9,6,8,24,33.3,16,30,3,27,10,40,19,0,1260.0
Mathias Pereira Lage,8,3,25,14.0,20,7,5,14,1,11,29,37.9,18,10,1,9,14,34,12,0,1260.0
Gabriel Suazo,0,3,24,14.0,38,22,20,15,3,29,63,46.0,34,21,5,16,22,60,24,1,1260.0
El Bilal Touré,3,2,20,14.0,4,3,2,1,1,0,3,0.0,3,6,1,5,1,5,23,0,1260.0
Evann Guessand,5,3,21,14.0,24,16,8,13,3,6,12,50.0,6,17,1,16,9,33,6,0,1260.0
